,Roll,Eng,Math,Sci,Total,Avg,Grade
211,448338,100,94,91,285,95.0,A+
469,828116,88,100,86,274,91.33333333333333,A+
507,623049,100,83,88,271,90.33333333333333,A+
546,762512,88,91,100,279,93.0,A+
572,274666,98,98,74,270,90.0,A+
634,521696,93,78,99,270,90.0,A+
840,124364,99,81,90,270,90.0,A+
910,972538,92,99,99,290,96.66666666666667,A+
1053,1029264,90,99,92,281,93.66666666666667,A+
1285,999366,80,91,100,271,90.33333333333333,A+
1295,374810,93,91,92,276,92.0,A+
1337,979612,89,89,99,277,92.33333333333333,A+
1750,502277,99,98,85,282,94.0,A+
1758,154427,99,87,94,280,93.33333333333333,A+
1799,728829,98,89,97,284,94.66666666666667,A+
1972,1042495,90,99,94,283,94.33333333333333,A+
2021,268853,79,93,98,270,90.0,A+
2096,643164,94,95,88,277,92.33333333333333,A+
2144,598507,93,88,96,277,92.33333333333333,A+
2256,830030,87,95,96,278,92.66666666666667,A+
2365,102243,94,95,82,271,90.33333333333333,A+
2491,102757,84,93,95,272,90.66666666666667,A+
2495,245405,90,97,94,281,93.66666666666667,A+
2514,937455,94,99,99,292,97.33333333333333,A+
2787,226348,99,94,93,286,95.33333333333333,A+
2827,280114,98,100,77,275,91.66666666666667,A+
2991,332244,91,81,99,271,90.33333333333333,A+
3420,590724,94,89,96,279,93.0,A+
3464,767231,90,97,88,275,91.66666666666667,A+
3495,373368,90,82,99,271,90.33333333333333,A+
3498,737591,82,99,93,274,91.33333333333333,A+
3804,299900,88,99,92,279,93.0,A+
3943,366324,100,83,90,273,91.0,A+
3983,902146,99,80,94,273,91.0,A+
4145,539164,88,94,96,278,92.66666666666667,A+
5293,868665,99,78,98,275,91.66666666666667,A+
6032,525418,98,96,80,274,91.33333333333333,A+
6178,791664,96,89,98,283,94.33333333333333,A+
6189,8050,95,87,98,280,93.33333333333333,A+
6296,983572,100,96,77,273,91.0,A+
6784,563669,79,99,99,277,92.33333333333333,A+
7106,682466,99,86,98,283,94.33333333333333,A+
7163,544361,94,85,98,277,92.33333333333333,A+
7236,532988,97,92,97,286,95.33333333333333,A+
7566,862746,87,100,84,271,90.33333333333333,A+
8003,637185,84,92,99,275,91.66666666666667,A+
8075,73018,86,95,95,276,92.0,A+
8078,385466,94,98,78,270,90.0,A+
8256,631841,99,80,94,273,91.0,A+
8491,521476,99,98,100,297,99.0,A+
8673,903686,92,89,91,272,90.66666666666667,A+
8897,234229,89,92,98,279,93.0,A+
9067,619528,86,98,100,284,94.66666666666667,A+
9085,879878,85,94,93,272,90.66666666666667,A+
9126,1021725,91,100,90,281,93.66666666666667,A+
9207,791492,97,91,88,276,92.0,A+
9354,816653,78,94,100,272,90.66666666666667,A+
9838,671088,92,93,100,285,95.0,A+
10075,329327,87,98,85,270,90.0,A+
10082,747220,96,85,89,270,90.0,A+
10213,89141,85,92,99,276,92.0,A+
10280,1010897,90,95,94,279,93.0,A+
10528,381095,93,92,90,275,91.66666666666667,A+
10714,127134,94,96,97,287,95.66666666666667,A+
11292,391392,84,96,100,280,93.33333333333333,A+
11318,156867,98,84,94,276,92.0,A+
11346,940023,75,97,100,272,90.66666666666667,A+
11638,346631,100,79,100,279,93.0,A+
11801,398410,100,87,86,273,91.0,A+
12004,351663,85,93,99,277,92.33333333333333,A+
12071,166992,91,90,93,274,91.33333333333333,A+
12080,174733,96,77,97,270,90.0,A+
12709,819281,96,92,84,272,90.66666666666667,A+
13038,982296,88,85,97,270,90.0,A+
13159,86836,92,85,93,270,90.0,A+
14214,336292,99,74,99,272,90.66666666666667,A+
14304,516547,90,97,90,277,92.33333333333333,A+
14429,612820,77,99,97,273,91.0,A+
14665,740525,90,96,86,272,90.66666666666667,A+
14808,178553,92,95,84,271,90.33333333333333,A+
14809,51271,87,96,100,283,94.33333333333333,A+
15155,874504,93,90,96,279,93.0,A+
15398,934789,83,94,99,276,92.0,A+
15593,995527,88,86,99,273,91.0,A+
15871,806913,71,99,100,270,90.0,A+
15978,306259,97,98,95,290,96.66666666666667,A+
16179,581192,86,93,99,278,92.66666666666667,A+
17104,524398,89,95,98,282,94.0,A+
17311,3243,98,96,87,281,93.66666666666667,A+
17594,610100,93,90,100,283,94.33333333333333,A+
17640,237518,90,99,92,281,93.66666666666667,A+
18011,132319,98,78,100,276,92.0,A+
18179,758813,81,98,99,278,92.66666666666667,A+
18350,758324,97,87,98,282,94.0,A+
18405,958004,90,90,100,280,93.33333333333333,A+
18707,437302,100,90,91,281,93.66666666666667,A+
19235,373135,93,92,100,285,95.0,A+
19274,995080,82,97,99,278,92.66666666666667,A+
19584,996725,90,95,94,279,93.0,A+
19876,503946,98,93,97,288,96.0,A+
20050,158616,91,92,96,279,93.0,A+
20397,483561,99,95,87,281,93.66666666666667,A+
20553,626461,98,76,99,273,91.0,A+
20808,601644,92,84,95,271,90.33333333333333,A+
20918,790202,97,92,90,279,93.0,A+
21037,994065,89,90,91,270,90.0,A+
21173,132514,94,100,91,285,95.0,A+
21214,724219,98,87,90,275,91.66666666666667,A+
21329,398062,100,88,86,274,91.33333333333333,A+
21416,1028713,100,100,85,285,95.0,A+
21738,306075,95,91,86,272,90.66666666666667,A+
21912,901412,99,80,100,279,93.0,A+
21996,608033,92,84,95,271,90.33333333333333,A+
22134,972886,92,98,99,289,96.33333333333333,A+
22242,197997,91,95,96,282,94.0,A+
22709,416258,94,100,97,291,97.0,A+
22843,954524,93,98,80,271,90.33333333333333,A+
23065,97035,93,90,98,281,93.66666666666667,A+
23109,462235,100,97,79,276,92.0,A+
23122,673111,92,91,92,275,91.66666666666667,A+
23366,969327,100,95,89,284,94.66666666666667,A+
23403,793479,80,99,91,270,90.0,A+
23466,760983,90,97,84,271,90.33333333333333,A+
23506,559247,97,98,76,271,90.33333333333333,A+
23783,838027,95,93,97,285,95.0,A+
23807,100721,98,73,99,270,90.0,A+
23981,14794,89,98,100,287,95.66666666666667,A+
24102,139558,100,88,95,283,94.33333333333333,A+
24164,966918,93,99,86,278,92.66666666666667,A+
24177,896319,92,88,100,280,93.33333333333333,A+
24479,531563,98,96,83,277,92.33333333333333,A+
24885,825738,95,91,92,278,92.66666666666667,A+
25086,968869,92,96,90,278,92.66666666666667,A+
25156,963036,91,94,94,279,93.0,A+
25242,1028921,99,99,89,287,95.66666666666667,A+
25256,153370,82,89,100,271,90.33333333333333,A+
25347,45022,87,96,96,279,93.0,A+
25580,133505,82,88,100,270,90.0,A+
25734,367412,93,93,86,272,90.66666666666667,A+
25786,928051,83,94,99,276,92.0,A+
26346,130619,92,92,96,280,93.33333333333333,A+
26421,503274,80,96,97,273,91.0,A+
26597,778293,96,88,100,284,94.66666666666667,A+
26931,90089,93,90,94,277,92.33333333333333,A+
26940,949274,98,81,100,279,93.0,A+
27063,820608,88,98,98,284,94.66666666666667,A+
27173,108761,100,82,96,278,92.66666666666667,A+
27381,9382,89,97,92,278,92.66666666666667,A+
27562,772503,90,97,100,287,95.66666666666667,A+
28043,351002,86,96,93,275,91.66666666666667,A+
28074,806711,80,100,93,273,91.0,A+
28174,864514,77,96,100,273,91.0,A+
28382,837563,77,94,100,271,90.33333333333333,A+
28405,695526,84,99,96,279,93.0,A+
28571,406995,84,95,93,272,90.66666666666667,A+
29594,401162,99,82,92,273,91.0,A+
29734,403718,100,88,93,281,93.66666666666667,A+
29829,279999,88,97,98,283,94.33333333333333,A+
29864,351418,100,83,96,279,93.0,A+
29969,577738,79,99,97,275,91.66666666666667,A+
30052,567606,93,82,95,270,90.0,A+
30461,503358,99,98,79,276,92.0,A+
30655,633981,86,98,91,275,91.66666666666667,A+
30687,578575,79,99,93,271,90.33333333333333,A+
30809,420782,98,84,94,276,92.0,A+
30920,511620,89,93,98,280,93.33333333333333,A+
31100,1012333,99,94,84,277,92.33333333333333,A+
31149,584585,87,99,96,282,94.0,A+
31670,664282,93,94,92,279,93.0,A+
31834,708262,90,89,100,279,93.0,A+
32032,115432,85,95,93,273,91.0,A+
32266,224709,99,96,95,290,96.66666666666667,A+
32461,767195,89,96,94,279,93.0,A+
33131,457448,100,93,82,275,91.66666666666667,A+
33449,890211,92,89,91,272,90.66666666666667,A+
33492,702361,90,89,95,274,91.33333333333333,A+
33949,160921,99,87,97,283,94.33333333333333,A+
34733,574569,96,96,78,270,90.0,A+
34776,489945,90,96,90,276,92.0,A+
34824,626504,92,88,96,276,92.0,A+
35081,252393,99,97,89,285,95.0,A+
35748,955882,92,95,86,273,91.0,A+
35909,472251,92,100,97,289,96.33333333333333,A+
35966,459949,89,88,93,270,90.0,A+
36259,335735,84,86,100,270,90.0,A+
36314,539102,97,95,84,276,92.0,A+
36482,774942,89,93,100,282,94.0,A+
36579,209516,82,99,95,276,92.0,A+
36580,531374,79,95,99,273,91.0,A+
37098,267355,79,96,97,272,90.66666666666667,A+
37194,680937,100,91,82,273,91.0,A+
37476,245063,99,97,91,287,95.66666666666667,A+
37482,743571,100,98,100,298,99.33333333333333,A+
37619,996132,91,95,96,282,94.0,A+
37749,183854,98,86,88,272,90.66666666666667,A+
37898,834469,88,99,92,279,93.0,A+
37963,200742,96,80,99,275,91.66666666666667,A+
38099,1040018,98,95,78,271,90.33333333333333,A+
38597,410211,100,89,95,284,94.66666666666667,A+
38612,326106,85,90,99,274,91.33333333333333,A+
39352,710255,98,87,94,279,93.0,A+
39446,20969,80,100,99,279,93.0,A+
39614,299521,97,98,95,290,96.66666666666667,A+
40278,161997,75,98,98,271,90.33333333333333,A+
40395,1029117,96,88,94,278,92.66666666666667,A+
40811,1023431,90,96,96,282,94.0,A+
41190,608289,95,94,92,281,93.66666666666667,A+
41508,604786,84,89,97,270,90.0,A+
41704,302382,97,97,82,276,92.0,A+
41887,17067,98,97,87,282,94.0,A+
42556,1013801,91,100,95,286,95.33333333333333,A+
43060,139240,92,90,92,274,91.33333333333333,A+
43129,537744,98,98,79,275,91.66666666666667,A+
43187,31521,97,97,78,272,90.66666666666667,A+
43296,325799,95,92,90,277,92.33333333333333,A+
43499,427312,98,85,90,273,91.0,A+
43515,628809,100,83,96,279,93.0,A+
43698,992677,99,91,88,278,92.66666666666667,A+
43873,238111,90,98,90,278,92.66666666666667,A+
43922,328795,93,87,93,273,91.0,A+
44090,2124,90,100,82,272,90.66666666666667,A+
44217,193428,100,94,80,274,91.33333333333333,A+
44632,932832,91,87,93,271,90.33333333333333,A+
44783,387240,93,93,92,278,92.66666666666667,A+
44810,880532,91,82,97,270,90.0,A+
44860,81914,100,81,98,279,93.0,A+
44909,869349,96,100,85,281,93.66666666666667,A+
45036,412993,90,85,97,272,90.66666666666667,A+
45072,76051,85,92,93,270,90.0,A+
45262,428926,100,92,93,285,95.0,A+
45344,912167,76,98,96,270,90.0,A+
45466,726378,97,83,98,278,92.66666666666667,A+
45574,895915,95,100,91,286,95.33333333333333,A+
46141,840210,92,79,99,270,90.0,A+
46270,23842,98,98,81,277,92.33333333333333,A+
46319,410632,100,90,82,272,90.66666666666667,A+
46718,306381,86,89,95,270,90.0,A+
46803,1008562,91,98,96,285,95.0,A+
46943,14279,99,100,87,286,95.33333333333333,A+
47186,956855,91,92,98,281,93.66666666666667,A+
47258,396570,95,100,87,282,94.0,A+
47451,175759,84,99,87,270,90.0,A+
47624,315112,94,87,89,270,90.0,A+
48059,596869,94,90,98,282,94.0,A+
48242,506129,94,80,99,273,91.0,A+
48367,485512,98,91,90,279,93.0,A+
48558,70676,93,88,96,277,92.33333333333333,A+
48603,355991,93,88,91,272,90.66666666666667,A+
48888,137491,99,82,90,271,90.33333333333333,A+
48963,733953,81,93,99,273,91.0,A+
49055,545387,97,97,83,277,92.33333333333333,A+
49183,473779,98,88,90,276,92.0,A+
49286,893427,93,93,98,284,94.66666666666667,A+
49500,311236,86,92,99,277,92.33333333333333,A+
49511,102164,100,83,92,275,91.66666666666667,A+
49760,182284,98,86,98,282,94.0,A+
49920,377213,91,86,97,274,91.33333333333333,A+
50175,387937,93,92,92,277,92.33333333333333,A+
50357,739522,100,98,77,275,91.66666666666667,A+
50415,560392,96,92,99,287,95.66666666666667,A+
50485,366538,93,92,96,281,93.66666666666667,A+
50622,705009,89,84,99,272,90.66666666666667,A+
51184,198088,88,84,99,271,90.33333333333333,A+
51246,472092,95,79,99,273,91.0,A+
51674,995997,99,95,97,291,97.0,A+
51912,1013795,98,90,92,280,93.33333333333333,A+
51916,392199,93,94,98,285,95.0,A+
52076,1017176,81,96,95,272,90.66666666666667,A+
52138,841623,87,98,100,285,95.0,A+
52330,744371,92,100,84,276,92.0,A+
52554,421033,92,94,94,280,93.33333333333333,A+
53143,509327,99,97,91,287,95.66666666666667,A+
53330,937271,92,91,90,273,91.0,A+
53850,903301,92,89,98,279,93.0,A+
53935,273860,98,96,93,287,95.66666666666667,A+
53987,494763,90,97,100,287,95.66666666666667,A+
54189,342314,87,99,90,276,92.0,A+
54190,141300,100,86,94,280,93.33333333333333,A+
54219,679006,82,92,99,273,91.0,A+
55189,12464,99,100,100,299,99.66666666666667,A+
55994,888083,93,90,98,281,93.66666666666667,A+
56191,287897,98,99,76,273,91.0,A+
56302,20841,98,99,98,295,98.33333333333333,A+
56693,409294,82,91,97,270,90.0,A+
56927,212407,97,84,92,273,91.0,A+
56961,489841,90,96,88,274,91.33333333333333,A+
57031,330202,95,95,93,283,94.33333333333333,A+
57089,69625,85,90,99,274,91.33333333333333,A+
57292,71575,99,76,97,272,90.66666666666667,A+
57319,336188,99,75,97,271,90.33333333333333,A+
57367,852438,86,93,97,276,92.0,A+
57847,778916,72,99,100,271,90.33333333333333,A+
58653,852640,92,81,99,272,90.66666666666667,A+
58838,213557,96,82,93,271,90.33333333333333,A+
58968,650593,100,84,86,270,90.0,A+
59061,599778,96,99,78,273,91.0,A+
59107,809963,97,94,88,279,93.0,A+
59182,313932,88,98,96,282,94.0,A+
59374,507688,99,99,94,292,97.33333333333333,A+
59648,364893,100,83,96,279,93.0,A+
59757,585605,97,100,79,276,92.0,A+
59771,210561,82,98,95,275,91.66666666666667,A+
60375,974066,83,98,97,278,92.66666666666667,A+
60415,836065,78,97,99,274,91.33333333333333,A+
60460,960597,92,97,94,283,94.33333333333333,A+
60496,867430,96,100,95,291,97.0,A+
60646,184802,91,95,88,274,91.33333333333333,A+
60675,782205,89,95,89,273,91.0,A+
60676,44153,88,99,86,273,91.0,A+
60769,1036350,90,98,92,280,93.33333333333333,A+
60788,230732,88,87,99,274,91.33333333333333,A+
62425,553446,96,93,95,284,94.66666666666667,A+
62504,601234,86,96,89,271,90.33333333333333,A+
62872,226085,87,84,99,270,90.0,A+
62901,809426,94,83,100,277,92.33333333333333,A+
63278,67404,96,96,80,272,90.66666666666667,A+
63409,896019,95,100,93,288,96.0,A+
63588,550694,98,98,89,285,95.0,A+
63601,778463,87,90,93,270,90.0,A+
63774,779215,99,100,83,282,94.0,A+
63927,767616,90,98,82,270,90.0,A+
63940,549300,98,100,89,287,95.66666666666667,A+
64186,157460,83,94,97,274,91.33333333333333,A+
64206,538014,88,96,94,278,92.66666666666667,A+
64473,215654,73,100,100,273,91.0,A+
64493,307886,78,97,99,274,91.33333333333333,A+
64800,60136,86,94,93,273,91.0,A+
64845,342724,93,86,95,274,91.33333333333333,A+
65191,238600,90,98,86,274,91.33333333333333,A+
65264,759032,91,100,80,271,90.33333333333333,A+
65337,626748,92,88,93,273,91.0,A+
65445,129329,93,93,98,284,94.66666666666667,A+
65763,924811,85,98,98,281,93.66666666666667,A+
65796,384697,94,97,90,281,93.66666666666667,A+
65873,150478,83,93,99,275,91.66666666666667,A+
65936,217482,99,95,99,293,97.66666666666667,A+
66088,553202,96,93,97,286,95.33333333333333,A+
66100,965127,90,91,93,274,91.33333333333333,A+
66182,747923,90,94,92,276,92.0,A+
66374,244464,90,98,96,284,94.66666666666667,A+
66463,30891,97,97,87,281,93.66666666666667,A+
66545,565528,96,95,95,286,95.33333333333333,A+
66895,828734,94,86,96,276,92.0,A+
67110,905637,76,96,100,272,90.66666666666667,A+
67229,228537,89,91,97,277,92.33333333333333,A+
67241,334243,93,88,96,277,92.33333333333333,A+
67384,939686,93,97,94,284,94.66666666666667,A+
67524,874516,96,100,95,291,97.0,A+
67680,487915,97,87,96,280,93.33333333333333,A+
67830,347615,93,90,94,277,92.33333333333333,A+
67965,101223,85,94,99,278,92.66666666666667,A+
68322,759724,90,95,100,285,95.0,A+
68475,499617,98,92,82,272,90.66666666666667,A+
69079,228371,98,93,84,275,91.66666666666667,A+
69518,521402,90,100,94,284,94.66666666666667,A+
69779,536558,98,99,83,280,93.33333333333333,A+
69799,926247,94,97,88,279,93.0,A+
69966,128870,99,84,94,277,92.33333333333333,A+
70112,528867,81,100,91,272,90.66666666666667,A+
70166,510825,98,94,93,285,95.0,A+
70254,950576,100,90,97,287,95.66666666666667,A+
70497,77983,95,97,99,291,97.0,A+
70501,808429,97,96,93,286,95.33333333333333,A+
71441,285930,80,99,99,278,92.66666666666667,A+
71971,72560,77,97,96,270,90.0,A+
72683,287568,95,86,92,273,91.0,A+
72733,968208,92,98,84,274,91.33333333333333,A+
72890,396980,100,88,93,281,93.66666666666667,A+
72916,341434,93,88,98,279,93.0,A+
73415,634329,86,98,91,275,91.66666666666667,A+
73552,182871,89,86,99,274,91.33333333333333,A+
73631,559211,97,97,82,276,92.0,A+
73857,128913,93,95,90,278,92.66666666666667,A+
73937,349510,95,98,89,282,94.0,A+
74057,635693,94,95,94,283,94.33333333333333,A+
74956,307751,87,96,100,283,94.33333333333333,A+
75067,542557,89,100,92,281,93.66666666666667,A+
75286,286633,88,97,96,281,93.66666666666667,A+
75298,1036240,96,89,88,273,91.0,A+
75510,506943,97,88,100,285,95.0,A+
76064,270503,96,91,90,277,92.33333333333333,A+
76317,1777,98,96,99,293,97.66666666666667,A+
76714,910742,85,98,100,283,94.33333333333333,A+
76724,364416,95,98,82,275,91.66666666666667,A+
77872,883932,86,98,96,280,93.33333333333333,A+
77942,641910,94,98,84,276,92.0,A+
78003,216993,91,99,86,276,92.0,A+
78030,815998,88,96,92,276,92.0,A+
78112,856871,78,97,97,272,90.66666666666667,A+
78158,225638,96,85,94,275,91.66666666666667,A+
78396,327658,96,99,91,286,95.33333333333333,A+
78939,341183,99,77,98,274,91.33333333333333,A+
79070,426651,99,87,84,270,90.0,A+
79231,1849,99,98,87,284,94.66666666666667,A+
79328,595235,95,96,80,271,90.33333333333333,A+
79363,329101,99,75,97,271,90.33333333333333,A+
79473,807615,95,87,92,274,91.33333333333333,A+
79501,856919,96,98,85,279,93.0,A+
79840,405955,93,96,90,279,93.0,A+
79853,697965,83,96,95,274,91.33333333333333,A+
79913,545595,97,96,87,280,93.33333333333333,A+
79970,1189,99,100,81,280,93.33333333333333,A+
80006,998259,90,94,90,274,91.33333333333333,A+
80202,949352,92,94,90,276,92.0,A+
80349,276973,99,100,98,297,99.0,A+
80428,237237,90,98,100,288,96.0,A+
80776,926559,93,96,94,283,94.33333333333333,A+
81082,714932,90,91,91,272,90.66666666666667,A+
81214,667529,100,89,91,280,93.33333333333333,A+
81622,524165,99,98,77,274,91.33333333333333,A+
81978,522380,90,100,86,276,92.0,A+
82465,1010506,96,84,98,278,92.66666666666667,A+
82741,934825,83,95,93,271,90.33333333333333,A+
82999,340841,93,88,100,281,93.66666666666667,A+
83525,160859,93,99,91,283,94.33333333333333,A+
83781,177771,89,84,97,270,90.0,A+
83864,672965,98,81,94,273,91.0,A+
84179,661458,93,97,99,289,96.33333333333333,A+
84509,264433,90,99,98,287,95.66666666666667,A+
84782,477068,99,94,85,278,92.66666666666667,A+
84983,191045,82,96,95,273,91.0,A+
85274,431298,100,90,84,274,91.33333333333333,A+
85471,502895,89,95,100,284,94.66666666666667,A+
85502,310373,96,94,86,276,92.0,A+
85602,251525,100,100,79,279,93.0,A+
85749,322278,96,95,97,288,96.0,A+
85868,21145,96,91,84,271,90.33333333333333,A+
86350,322406,93,86,93,272,90.66666666666667,A+
86387,961740,98,85,94,277,92.33333333333333,A+
86765,816157,100,73,97,270,90.0,A+
87180,867027,100,80,100,280,93.33333333333333,A+
87248,199182,91,94,92,277,92.33333333333333,A+
87740,951762,100,89,93,282,94.0,A+
87756,865223,95,94,94,283,94.33333333333333,A+
87782,692737,100,92,91,283,94.33333333333333,A+
87915,920903,93,95,88,276,92.0,A+
87973,978608,99,91,91,281,93.66666666666667,A+
88092,684704,92,94,96,282,94.0,A+
88133,809339,98,98,76,272,90.66666666666667,A+
88240,766596,96,86,94,276,92.0,A+
88386,460762,91,97,94,282,94.0,A+
88468,585973,78,97,99,274,91.33333333333333,A+
88733,557560,95,89,86,270,90.0,A+
88773,186019,90,92,98,280,93.33333333333333,A+
88939,240520,98,93,93,284,94.66666666666667,A+
89048,830488,96,94,95,285,95.0,A+
89110,592264,87,98,94,279,93.0,A+
89211,301105,100,75,97,272,90.66666666666667,A+
89357,797631,87,92,93,272,90.66666666666667,A+
89452,152825,100,90,91,281,93.66666666666667,A+
89466,1016271,81,98,91,270,90.0,A+
89538,384898,100,85,92,277,92.33333333333333,A+
89923,830721,78,95,98,271,90.33333333333333,A+
90351,316616,87,95,93,275,91.66666666666667,A+
90482,308002,96,96,95,287,95.66666666666667,A+
90606,356424,96,100,78,274,91.33333333333333,A+
90746,480224,94,77,99,270,90.0,A+
90801,435652,97,82,94,273,91.0,A+
91039,44715,97,97,87,281,93.66666666666667,A+
91140,486056,95,80,95,270,90.0,A+
91458,864666,95,95,90,280,93.33333333333333,A+
91520,78662,99,75,97,271,90.33333333333333,A+
91913,793033,90,100,86,276,92.0,A+
92170,389093,86,100,96,282,94.0,A+
92303,897554,95,99,89,283,94.33333333333333,A+
92826,96698,96,100,97,293,97.66666666666667,A+
92853,1009441,100,98,83,281,93.66666666666667,A+
92868,259077,86,87,99,272,90.66666666666667,A+
93014,833068,95,91,90,276,92.0,A+
93778,972183,99,89,97,285,95.0,A+
94110,812439,96,92,82,270,90.0,A+
94134,453915,83,97,95,275,91.66666666666667,A+
94185,270583,99,99,98,296,98.66666666666667,A+
94276,571452,79,98,99,276,92.0,A+
94341,36223,79,100,93,272,90.66666666666667,A+
94422,348709,96,99,87,282,94.0,A+
94467,544189,80,98,93,271,90.33333333333333,A+
94542,419174,90,87,93,270,90.0,A+
94586,543248,80,99,95,274,91.33333333333333,A+
94760,431090,100,91,80,271,90.33333333333333,A+
94895,591812,87,99,92,278,92.66666666666667,A+
94963,954660,92,95,96,283,94.33333333333333,A+
95023,285196,95,88,100,283,94.33333333333333,A+
95338,570419,97,98,93,288,96.0,A+
95703,206483,99,92,93,284,94.66666666666667,A+
95837,462260,91,94,96,281,93.66666666666667,A+
95974,183298,83,98,89,270,90.0,A+
96453,464003,90,92,96,278,92.66666666666667,A+
96850,438103,99,89,92,280,93.33333333333333,A+
97215,974525,92,96,96,284,94.66666666666667,A+
97218,34787,86,90,97,273,91.0,A+
97229,856235,99,76,97,272,90.66666666666667,A+
97538,614630,92,84,99,275,91.66666666666667,A+
97568,4840,88,94,93,275,91.66666666666667,A+
98207,573035,97,97,82,276,92.0,A+
98326,948936,92,96,82,270,90.0,A+
98763,970813,82,93,97,272,90.66666666666667,A+
98942,599693,93,87,91,271,90.33333333333333,A+
98966,169297,98,86,94,278,92.66666666666667,A+
99025,195942,92,99,90,281,93.66666666666667,A+
99362,326705,94,90,94,278,92.66666666666667,A+
99458,101119,85,95,97,277,92.33333333333333,A+
99463,2198,98,98,87,283,94.33333333333333,A+
99724,486179,91,99,99,289,96.33333333333333,A+
99884,959093,84,100,96,280,93.33333333333333,A+
100223,910681,95,100,89,284,94.66666666666667,A+
100623,770650,97,89,96,282,94.0,A+
100628,966221,93,100,86,279,93.0,A+
100809,195893,89,88,97,274,91.33333333333333,A+
100810,572113,93,85,100,278,92.66666666666667,A+
100853,882838,99,77,98,274,91.33333333333333,A+
101290,979862,83,99,100,282,94.0,A+
101378,83223,96,99,97,292,97.33333333333333,A+
102095,533654,97,94,82,273,91.0,A+
102521,654096,94,100,87,281,93.66666666666667,A+
102836,504159,99,96,81,276,92.0,A+
102923,641826,91,85,97,273,91.0,A+
103119,267990,89,96,85,270,90.0,A+
103275,414472,93,95,84,272,90.66666666666667,A+
103473,865883,94,92,100,286,95.33333333333333,A+
103490,368586,98,78,100,276,92.0,A+
103602,797637,97,92,90,279,93.0,A+
103664,937944,94,99,95,288,96.0,A+
103706,409410,100,90,93,283,94.33333333333333,A+
103755,245686,90,98,86,274,91.33333333333333,A+
103935,414081,83,95,93,271,90.33333333333333,A+
103977,1030939,90,98,84,272,90.66666666666667,A+
104069,195551,83,99,99,281,93.66666666666667,A+
104079,209906,92,100,86,278,92.66666666666667,A+
104306,931585,85,100,92,277,92.33333333333333,A+
104345,117603,86,100,100,286,95.33333333333333,A+
104381,173131,81,91,99,271,90.33333333333333,A+
104779,835061,88,99,90,277,92.33333333333333,A+
104799,759527,100,100,73,273,91.0,A+
105194,1024122,80,96,99,275,91.66666666666667,A+
105295,450974,81,91,100,272,90.66666666666667,A+
105297,749421,89,91,93,273,91.0,A+
105408,939961,100,88,84,272,90.66666666666667,A+
105774,426028,92,97,94,283,94.33333333333333,A+
105775,194988,90,90,93,273,91.0,A+
105953,134599,100,87,88,275,91.66666666666667,A+
107177,821091,95,88,92,275,91.66666666666667,A+
107337,772429,81,99,95,275,91.66666666666667,A+
107456,35386,95,89,92,276,92.0,A+
107477,190708,100,96,89,285,95.0,A+
107478,746132,87,85,99,271,90.33333333333333,A+
107623,834755,98,100,81,279,93.0,A+
107791,139802,100,88,93,281,93.66666666666667,A+
107884,324473,95,92,98,285,95.0,A+
107885,92998,96,100,74,270,90.0,A+
107999,220655,98,92,93,283,94.33333333333333,A+
108472,221903,89,90,99,278,92.66666666666667,A+
108582,497478,80,95,95,270,90.0,A+
108757,644932,99,80,100,279,93.0,A+
108803,165182,92,94,86,272,90.66666666666667,A+
108832,215207,98,90,90,278,92.66666666666667,A+
109504,179386,90,91,100,281,93.66666666666667,A+
109751,152881,97,78,99,274,91.33333333333333,A+
109843,47223,95,92,94,281,93.66666666666667,A+
110594,688726,93,100,84,277,92.33333333333333,A+
110857,230505,99,97,98,294,98.0,A+
110867,1023670,81,97,97,275,91.66666666666667,A+
110880,801575,79,97,97,273,91.0,A+
111148,425013,84,100,91,275,91.66666666666667,A+
111176,730235,100,98,96,294,98.0,A+
111280,557732,94,86,96,276,92.0,A+
111433,277069,97,94,80,271,90.33333333333333,A+
111576,976792,91,95,86,272,90.66666666666667,A+
112781,537463,98,97,87,282,94.0,A+
113038,257242,90,100,96,286,95.33333333333333,A+
113040,211722,100,95,91,286,95.33333333333333,A+
113359,494934,81,99,93,273,91.0,A+
113676,123563,84,93,93,270,90.0,A+
113748,527889,81,100,99,280,93.33333333333333,A+
113775,626240,96,100,83,279,93.0,A+
113891,86604,95,95,95,285,95.0,A+
113938,171156,100,93,95,288,96.0,A+
113997,149188,99,84,96,279,93.0,A+
114024,230774,97,88,90,275,91.66666666666667,A+
114043,166337,100,92,85,277,92.33333333333333,A+
114135,917266,76,100,99,275,91.66666666666667,A+
114167,616036,94,92,98,284,94.66666666666667,A+
114185,651321,99,80,100,279,93.0,A+
114220,732149,91,97,88,276,92.0,A+
114435,573341,87,96,91,274,91.33333333333333,A+
114485,1020777,98,90,90,278,92.66666666666667,A+
114513,234926,89,92,98,279,93.0,A+
114556,255566,98,94,82,274,91.33333333333333,A+
114968,437437,91,91,89,271,90.33333333333333,A+
114972,815216,100,74,100,274,91.33333333333333,A+
115233,127819,91,86,97,274,91.33333333333333,A+
115364,321563,100,76,95,271,90.33333333333333,A+
115461,931750,91,87,99,277,92.33333333333333,A+
115491,630031,85,94,91,270,90.0,A+
115615,58539,96,97,87,280,93.33333333333333,A+
116000,563559,70,100,100,270,90.0,A+
116155,368421,93,90,92,275,91.66666666666667,A+
116253,626864,95,97,95,287,95.66666666666667,A+
116571,315503,88,98,85,271,90.33333333333333,A+
116980,159844,100,91,82,273,91.0,A+
117584,669718,90,86,95,271,90.33333333333333,A+
117618,995649,100,95,97,292,97.33333333333333,A+
117670,792477,98,97,100,295,98.33333333333333,A+
117903,203346,100,97,93,290,96.66666666666667,A+
118392,191467,91,93,100,284,94.66666666666667,A+
118744,606297,86,97,98,281,93.66666666666667,A+
119043,943037,100,91,95,286,95.33333333333333,A+
119255,983634,91,95,88,274,91.33333333333333,A+
119816,988935,97,86,92,275,91.66666666666667,A+
119941,72639,95,94,99,288,96.0,A+
119993,392724,93,96,88,277,92.33333333333333,A+
120330,619845,87,100,85,272,90.66666666666667,A+
120793,232486,90,95,98,283,94.33333333333333,A+
120914,721847,98,89,99,286,95.33333333333333,A+
121529,634996,94,96,95,285,95.0,A+
121742,925306,94,98,91,283,94.33333333333333,A+
121940,292882,88,98,100,286,95.33333333333333,A+
122046,1009057,100,97,89,286,95.33333333333333,A+
122457,787470,95,85,100,280,93.33333333333333,A+
122556,268370,88,93,100,281,93.66666666666667,A+
122559,306797,100,77,98,275,91.66666666666667,A+
122575,987542,82,98,97,277,92.33333333333333,A+
122783,586859,96,97,82,275,91.66666666666667,A+
123210,169193,83,97,97,277,92.33333333333333,A+
123384,380931,95,100,99,294,98.0,A+
123685,84585,96,100,83,279,93.0,A+
124304,147659,85,100,85,270,90.0,A+
124309,251280,100,100,81,281,93.66666666666667,A+
124344,355887,93,89,89,271,90.33333333333333,A+
124445,889520,86,100,94,280,93.33333333333333,A+
125575,232950,99,98,77,274,91.33333333333333,A+
125866,407,81,100,99,280,93.33333333333333,A+
126345,257969,96,89,88,273,91.0,A+
126660,366917,100,82,88,270,90.0,A+
126753,333595,97,100,89,286,95.33333333333333,A+
126821,523181,90,98,88,276,92.0,A+
126844,419150,92,96,99,287,95.66666666666667,A+
127058,702263,99,89,90,278,92.66666666666667,A+
127180,146919,76,100,94,270,90.0,A+
127511,878582,76,96,98,270,90.0,A+
128230,962657,100,93,97,290,96.66666666666667,A+
128267,1003473,100,99,71,270,90.0,A+
128342,886860,85,94,91,270,90.0,A+
128392,593280,95,95,97,287,95.66666666666667,A+
128556,505205,98,95,80,273,91.0,A+
128570,675948,93,99,84,276,92.0,A+
128847,730462,89,88,97,274,91.33333333333333,A+
129016,495331,100,99,81,280,93.33333333333333,A+
129078,726658,97,84,90,271,90.33333333333333,A+
129144,950538,92,93,85,270,90.0,A+
129351,85442,93,87,93,273,91.0,A+
129460,772575,90,99,88,277,92.33333333333333,A+
129726,479233,92,100,95,287,95.66666666666667,A+
130158,990544,90,93,98,281,93.66666666666667,A+
130258,1005407,96,82,95,273,91.0,A+
130336,998119,90,93,94,277,92.33333333333333,A+
130601,154011,84,100,91,275,91.66666666666667,A+
130957,879591,91,83,99,273,91.0,A+
131160,441729,98,85,88,271,90.33333333333333,A+
131219,534254,99,99,100,298,99.33333333333333,A+
131414,159245,91,92,87,270,90.0,A+
131464,45376,96,95,93,284,94.66666666666667,A+
131740,441448,98,83,96,277,92.33333333333333,A+
131833,356792,77,97,98,272,90.66666666666667,A+
131952,188257,99,89,90,278,92.66666666666667,A+
131979,952697,75,99,98,272,90.66666666666667,A+
132303,3830,89,96,88,273,91.0,A+
132495,206434,96,81,100,277,92.33333333333333,A+
132817,854437,88,100,94,282,94.0,A+
132853,689766,84,99,87,270,90.0,A+
133105,120152,94,96,99,289,96.33333333333333,A+
133202,682679,100,89,82,271,90.33333333333333,A+
133216,377323,100,85,96,281,93.66666666666667,A+
133282,333784,100,79,92,271,90.33333333333333,A+
133340,807836,97,96,95,288,96.0,A+
133476,963446,97,81,100,278,92.66666666666667,A+
133838,180894,100,92,78,270,90.0,A+
133999,857776,92,85,95,272,90.66666666666667,A+
134824,253146,95,85,98,278,92.66666666666667,A+
135019,818375,96,94,80,270,90.0,A+
135107,393929,90,82,99,271,90.33333333333333,A+
135159,725124,82,96,99,277,92.33333333333333,A+
135236,281149,88,95,100,283,94.33333333333333,A+
135644,263020,94,81,97,272,90.66666666666667,A+
135648,418275,84,99,91,274,91.33333333333333,A+
135705,1015434,97,88,90,275,91.66666666666667,A+
136033,409759,85,100,98,283,94.33333333333333,A+
136056,877946,98,74,99,271,90.33333333333333,A+
136285,767892,89,95,94,278,92.66666666666667,A+
136378,501812,97,89,84,270,90.0,A+
136382,203553,92,100,80,272,90.66666666666667,A+
136422,453218,83,98,95,276,92.0,A+
136563,696076,90,87,97,274,91.33333333333333,A+
136646,667767,91,89,91,271,90.33333333333333,A+
136665,399878,93,94,96,283,94.33333333333333,A+
136809,578783,78,98,97,273,91.0,A+
137099,770234,97,92,88,277,92.33333333333333,A+
137109,1033391,100,100,100,300,100.0,A+
137570,834420,85,88,99,272,90.66666666666667,A+
137675,495038,97,88,90,275,91.66666666666667,A+
137856,342485,86,96,100,282,94.0,A+
137985,487353,88,89,95,272,90.66666666666667,A+
138615,482589,100,98,75,273,91.0,A+
138691,340137,100,79,98,277,92.33333333333333,A+
138945,458421,99,89,95,283,94.33333333333333,A+
139021,561119,87,92,95,274,91.33333333333333,A+
139054,225228,91,97,88,276,92.0,A+
139081,996621,91,96,92,279,93.0,A+
139340,234559,100,100,100,300,100.0,A+
139364,514982,99,97,97,293,97.66666666666667,A+
139577,141404,99,85,96,280,93.33333333333333,A+
139595,688758,93,97,99,289,96.33333333333333,A+
139685,982864,91,94,100,285,95.0,A+
139797,572504,87,96,96,279,93.0,A+
139820,1019700,99,95,76,270,90.0,A+
139871,635895,100,83,96,279,93.0,A+
140191,72363,96,97,87,280,93.33333333333333,A+
140311,725014,73,97,100,270,90.0,A+
140754,267440,98,98,79,275,91.66666666666667,A+
140763,389399,92,88,100,280,93.33333333333333,A+
140794,149432,99,84,94,277,92.33333333333333,A+
140969,265123,96,88,96,280,93.33333333333333,A+
140999,709209,83,99,100,282,94.0,A+
141020,307964,88,99,84,271,90.33333333333333,A+
141224,541866,99,100,89,288,96.0,A+
141418,28275,98,98,97,293,97.66666666666667,A+
141600,159912,100,90,91,281,93.66666666666667,A+
141647,604542,84,89,99,272,90.66666666666667,A+
141822,340773,78,100,97,275,91.66666666666667,A+
142545,61958,88,100,100,288,96.0,A+
142653,774562,89,97,86,272,90.66666666666667,A+
142809,172934,100,91,89,280,93.33333333333333,A+
142978,927006,84,95,99,278,92.66666666666667,A+
143409,359452,94,92,96,282,94.0,A+
143648,746279,81,96,97,274,91.33333333333333,A+
143718,460298,89,88,93,270,90.0,A+
143789,288522,97,95,89,281,93.66666666666667,A+
143833,4039,89,95,92,276,92.0,A+
144031,82715,100,79,100,279,93.0,A+
144317,134667,100,85,96,281,93.66666666666667,A+
144494,1012432,89,93,89,271,90.33333333333333,A+
144647,455902,82,95,93,270,90.0,A+
144696,437511,84,100,100,284,94.66666666666667,A+
144864,484643,99,94,80,273,91.0,A+
145030,178132,91,93,96,280,93.33333333333333,A+
145117,63933,84,88,99,271,90.33333333333333,A+
145149,641598,95,99,78,272,90.66666666666667,A+
145376,295363,97,95,91,283,94.33333333333333,A+
145773,541829,98,99,96,293,97.66666666666667,A+
145829,94417,85,95,91,271,90.33333333333333,A+
145846,369467,77,99,97,273,91.0,A+
145905,989815,91,97,84,272,90.66666666666667,A+
146016,314763,94,88,89,271,90.33333333333333,A+
146054,548628,96,92,84,272,90.66666666666667,A+
146180,9945,98,96,93,287,95.66666666666667,A+
146196,502765,99,98,81,278,92.66666666666667,A+
146300,809230,97,94,95,286,95.33333333333333,A+
146595,161000,93,100,86,279,93.0,A+
146636,205223,91,95,92,278,92.66666666666667,A+
146688,209821,88,87,99,274,91.33333333333333,A+
146758,975887,92,97,82,271,90.33333333333333,A+
146868,1018655,99,96,76,271,90.33333333333333,A+
147129,369332,86,98,98,282,94.0,A+
147359,600683,96,97,82,275,91.66666666666667,A+
147462,1043723,99,99,81,279,93.0,A+
147487,529075,96,89,90,275,91.66666666666667,A+
147576,735114,98,91,95,284,94.66666666666667,A+
147631,496548,99,95,91,285,95.0,A+
147725,944639,100,88,99,287,95.66666666666667,A+
147998,157215,98,83,94,275,91.66666666666667,A+
148086,590870,88,100,94,282,94.0,A+
148528,424732,84,98,100,282,94.0,A+
148574,987059,92,98,99,289,96.33333333333333,A+
148768,508263,72,99,100,271,90.33333333333333,A+
148839,774483,95,84,96,275,91.66666666666667,A+
148848,579584,78,96,99,273,91.0,A+
148850,719969,100,95,83,278,92.66666666666667,A+
148883,404158,82,88,100,270,90.0,A+
149287,960975,99,87,86,272,90.66666666666667,A+
149363,445740,89,87,99,275,91.66666666666667,A+
149380,683584,99,87,86,272,90.66666666666667,A+
149461,35636,89,100,92,281,93.66666666666667,A+
149562,196364,100,96,96,292,97.33333333333333,A+
149655,581534,92,82,97,271,90.33333333333333,A+
149661,102617,84,92,99,275,91.66666666666667,A+
149682,642565,85,96,93,274,91.33333333333333,A+
149883,334977,78,99,95,272,90.66666666666667,A+
150322,961037,89,86,97,272,90.66666666666667,A+
150455,544928,89,98,83,270,90.0,A+
150656,775541,98,93,95,286,95.33333333333333,A+
150751,363487,98,75,97,270,90.0,A+
150817,570107,98,100,87,285,95.0,A+
150893,71110,97,100,83,280,93.33333333333333,A+
150916,920096,100,86,84,270,90.0,A+
150997,1036179,99,96,99,294,98.0,A+
151124,78258,87,98,94,279,93.0,A+
151306,590229,100,79,98,277,92.33333333333333,A+
152149,953051,99,88,90,277,92.33333333333333,A+
152302,857880,92,84,97,273,91.0,A+
152307,913188,93,95,96,284,94.66666666666667,A+
152511,858173,95,95,88,278,92.66666666666667,A+
152755,792544,90,100,90,280,93.33333333333333,A+
152849,315082,87,96,98,281,93.66666666666667,A+
153079,527332,97,91,90,278,92.66666666666667,A+
153680,222758,100,99,92,291,97.0,A+
153947,161935,84,99,87,270,90.0,A+
154250,32237,78,94,98,270,90.0,A+
154365,44159,97,98,83,278,92.66666666666667,A+
155546,874185,100,82,88,270,90.0,A+
155688,728657,99,92,86,277,92.33333333333333,A+
156095,184349,92,96,86,274,91.33333333333333,A+
156105,1045173,95,86,89,270,90.0,A+
156209,1007931,98,91,82,271,90.33333333333333,A+
156411,488281,100,100,75,275,91.66666666666667,A+
156534,762854,95,81,97,273,91.0,A+
156572,765880,100,100,79,279,93.0,A+
156860,421938,91,92,98,281,93.66666666666667,A+
156939,7890,99,100,87,286,95.33333333333333,A+
157179,288265,94,85,91,270,90.0,A+
157562,669168,84,98,93,275,91.66666666666667,A+
158165,833876,88,100,94,282,94.0,A+
158490,770338,97,91,90,278,92.66666666666667,A+
158587,624033,94,94,82,270,90.0,A+
158662,793687,96,88,90,274,91.33333333333333,A+
158869,690176,90,87,93,270,90.0,A+
158946,669516,84,97,93,274,91.33333333333333,A+
159316,891825,94,96,95,285,95.0,A+
159549,648642,85,98,87,270,90.0,A+
159594,796195,94,83,97,274,91.33333333333333,A+
159599,384752,91,85,99,275,91.66666666666667,A+
159667,434704,89,84,99,272,90.66666666666667,A+
159816,36828,97,99,85,281,93.66666666666667,A+
159929,990164,91,97,84,272,90.66666666666667,A+
160144,205962,100,95,83,278,92.66666666666667,A+
160461,33820,96,93,82,271,90.33333333333333,A+
160774,584524,97,100,85,282,94.0,A+
160863,606743,92,86,97,275,91.66666666666667,A+
160909,266040,90,100,82,272,90.66666666666667,A+
160938,828135,100,76,96,272,90.66666666666667,A+
161328,306876,79,100,93,272,90.66666666666667,A+
161365,632092,93,90,94,277,92.33333333333333,A+
161473,425013,100,89,86,275,91.66666666666667,A+
161987,375513,86,100,94,280,93.33333333333333,A+
162185,1018993,89,92,100,281,93.66666666666667,A+
162230,726842,99,92,99,290,96.66666666666667,A+
162262,872052,92,84,97,273,91.0,A+
162398,271763,89,99,96,284,94.66666666666667,A+
162444,400563,90,83,97,270,90.0,A+
162771,380802,90,81,99,270,90.0,A+
162830,431714,99,88,92,279,93.0,A+
162841,54059,86,92,99,277,92.33333333333333,A+
162901,1026427,88,91,100,279,93.0,A+
163013,928962,92,91,100,283,94.33333333333333,A+
163016,757699,97,90,86,273,91.0,A+
163104,942823,92,93,94,279,93.0,A+
163249,6772,99,99,100,298,99.33333333333333,A+
164236,947683,93,99,78,270,90.0,A+
164481,141233,85,98,91,274,91.33333333333333,A+
164767,86187,95,97,86,278,92.66666666666667,A+
164826,886205,95,96,82,273,91.0,A+
165057,357141,77,97,98,272,90.66666666666667,A+
165218,37685,94,85,96,275,91.66666666666667,A+
165685,102378,93,92,98,283,94.33333333333333,A+
165757,586566,78,97,96,271,90.33333333333333,A+
166526,439565,98,85,100,283,94.33333333333333,A+
166768,498144,89,92,98,279,93.0,A+
167282,808673,97,96,91,284,94.66666666666667,A+
167650,53997,95,93,88,276,92.0,A+
168300,756025,98,91,95,284,94.66666666666667,A+
168427,847791,85,89,97,271,90.33333333333333,A+
168447,458561,99,90,90,279,93.0,A+
169209,438488,99,90,86,275,91.66666666666667,A+
169478,342252,96,100,78,274,91.33333333333333,A+
169660,207314,90,92,91,273,91.0,A+
169892,380331,94,95,82,271,90.33333333333333,A+
169894,313694,97,98,95,290,96.66666666666667,A+
170290,901485,100,82,88,270,90.0,A+
170536,782449,89,95,87,271,90.33333333333333,A+
170967,520179,97,93,82,272,90.66666666666667,A+
171020,854187,94,90,94,278,92.66666666666667,A+
171046,561542,95,90,100,285,95.0,A+
171269,661831,91,87,93,271,90.33333333333333,A+
171493,57237,94,88,90,272,90.66666666666667,A+
171655,875317,96,99,97,292,97.33333333333333,A+
171795,762518,98,91,97,286,95.33333333333333,A+
171892,815851,94,85,93,272,90.66666666666667,A+
171935,614507,95,97,82,274,91.33333333333333,A+
172281,316824,86,94,97,277,92.33333333333333,A+
172297,467817,92,99,80,271,90.33333333333333,A+
172429,822791,85,85,100,270,90.0,A+
172788,103044,94,94,84,272,90.66666666666667,A+
172813,804895,96,89,100,285,95.0,A+
173199,308178,97,98,85,280,93.33333333333333,A+
173262,990654,99,92,97,288,96.0,A+
173454,757914,91,99,92,282,94.0,A+
173494,317179,95,93,94,282,94.0,A+
173696,126358,76,100,94,270,90.0,A+
173697,343537,95,95,97,287,95.66666666666667,A+
173712,104219,99,79,98,276,92.0,A+
173786,855085,100,78,96,274,91.33333333333333,A+
174720,1033941,98,93,84,275,91.66666666666667,A+
174726,961043,83,96,99,278,92.66666666666667,A+
174883,386959,93,92,100,285,95.0,A+
175014,1027485,91,100,99,290,96.66666666666667,A+
175050,260721,95,84,94,273,91.0,A+
175763,853710,97,100,97,294,98.0,A+
175832,973320,96,77,99,272,90.66666666666667,A+
175934,768553,89,93,100,282,94.0,A+
175999,805849,98,99,98,295,98.33333333333333,A+
176266,999372,89,91,98,278,92.66666666666667,A+
176301,334586,100,78,93,271,90.33333333333333,A+
176359,270540,97,92,84,273,91.0,A+
176416,690983,83,95,97,275,91.66666666666667,A+
176745,623263,94,92,94,280,93.33333333333333,A+
176767,456073,97,82,98,277,92.33333333333333,A+
177458,821293,85,87,99,271,90.33333333333333,A+
177525,44110,94,87,89,270,90.0,A+
177908,554179,96,93,88,277,92.33333333333333,A+
178130,230224,91,100,88,279,93.0,A+
178445,70016,94,90,90,274,91.33333333333333,A+
178721,907978,99,83,90,272,90.66666666666667,A+
179240,441106,91,94,98,283,94.33333333333333,A+
179568,159105,91,92,92,275,91.66666666666667,A+
179635,629744,91,83,97,271,90.33333333333333,A+
179685,926100,100,87,90,277,92.33333333333333,A+
180265,648123,94,97,95,286,95.33333333333333,A+
180423,1047801,98,94,78,270,90.0,A+
180858,438752,96,77,99,272,90.66666666666667,A+
180886,252241,96,87,94,277,92.33333333333333,A+
180905,751971,97,87,92,276,92.0,A+
180992,156030,98,84,98,280,93.33333333333333,A+
181021,909440,98,79,98,275,91.66666666666667,A+
181368,209099,98,91,82,271,90.33333333333333,A+
181536,452967,74,99,100,273,91.0,A+
181668,802314,88,97,87,272,90.66666666666667,A+
181870,933744,84,95,99,278,92.66666666666667,A+
181970,824191,93,82,97,272,90.66666666666667,A+
182217,197397,97,85,96,278,92.66666666666667,A+
183049,306185,89,100,90,279,93.0,A+
183253,224116,99,96,97,292,97.33333333333333,A+
183259,385143,100,85,90,275,91.66666666666667,A+
183848,32946,96,93,92,281,93.66666666666667,A+
184035,898667,94,95,97,286,95.33333333333333,A+
184134,924847,85,100,92,277,92.33333333333333,A+
184453,877439,86,97,94,277,92.33333333333333,A+
184675,391251,100,85,98,283,94.33333333333333,A+
184730,823146,93,84,97,274,91.33333333333333,A+
185071,273640,80,97,95,272,90.66666666666667,A+
185127,880783,84,92,97,273,91.0,A+
185219,629157,100,83,96,279,93.0,A+
185227,208506,99,91,84,274,91.33333333333333,A+
185271,232737,99,95,93,287,95.66666666666667,A+
185714,897377,94,97,99,290,96.66666666666667,A+
185789,354347,84,90,97,271,90.33333333333333,A+
186053,714339,90,92,94,276,92.0,A+
186681,121821,100,85,88,273,91.0,A+
186738,246946,98,95,87,280,93.33333333333333,A+
186882,410742,94,100,87,281,93.66666666666667,A+
187088,311278,95,92,90,277,92.33333333333333,A+
187198,1020393,97,90,97,284,94.66666666666667,A+
187461,391611,94,99,80,273,91.0,A+
187954,744829,100,99,83,282,94.0,A+
187994,203334,98,87,94,279,93.0,A+
188042,1036588,96,88,88,272,90.66666666666667,A+
188045,724439,100,96,93,289,96.33333333333333,A+
188412,716534,89,88,95,272,90.66666666666667,A+
188426,217445,91,98,88,277,92.33333333333333,A+
188591,814500,89,99,90,278,92.66666666666667,A+
188905,91672,96,100,83,279,93.0,A+
189257,302413,96,94,97,287,95.66666666666667,A+
189343,100011,95,97,86,278,92.66666666666667,A+
190119,50824,96,96,95,287,95.66666666666667,A+
190197,316518,96,95,88,279,93.0,A+
190226,280244,88,97,96,281,93.66666666666667,A+
190615,457119,96,81,98,275,91.66666666666667,A+
190645,418562,94,100,80,274,91.33333333333333,A+
190860,884323,95,98,87,280,93.33333333333333,A+
190873,779906,90,99,86,275,91.66666666666667,A+
191333,58221,88,99,83,270,90.0,A+
191377,1035953,87,88,99,274,91.33333333333333,A+
191394,737352,91,99,92,282,94.0,A+
191696,96655,94,93,84,271,90.33333333333333,A+
191889,979153,80,90,100,270,90.0,A+
191991,438629,99,90,82,271,90.33333333333333,A+
191999,21249,96,91,86,273,91.0,A+
192295,1022031,97,88,94,279,93.0,A+
192327,189474,98,85,100,283,94.33333333333333,A+
192534,808392,97,95,99,291,97.0,A+
192599,955002,98,84,94,276,92.0,A+
192744,669070,93,98,88,279,93.0,A+
193183,110363,99,79,100,278,92.66666666666667,A+
193269,277798,80,100,99,279,93.0,A+
193517,700973,99,90,93,282,94.0,A+
193623,634042,92,86,97,275,91.66666666666667,A+
193901,49222,97,99,91,287,95.66666666666667,A+
194008,1008696,82,98,95,275,91.66666666666667,A+
194181,1036766,89,96,100,285,95.0,A+
194321,23274,88,96,100,284,94.66666666666667,A+
194645,284988,95,89,96,280,93.33333333333333,A+
194780,741020,99,95,78,272,90.66666666666667,A+
194922,559683,93,83,99,275,91.66666666666667,A+
195551,753231,90,95,98,283,94.33333333333333,A+
195740,232584,96,84,98,278,92.66666666666667,A+
195769,592020,87,98,96,281,93.66666666666667,A+
195858,696467,83,98,93,274,91.33333333333333,A+
195872,887527,93,92,94,279,93.0,A+
196296,706660,91,92,96,279,93.0,A+
196511,628331,95,97,82,274,91.33333333333333,A+
196619,740098,96,84,96,276,92.0,A+
196652,639637,86,99,98,283,94.33333333333333,A+
196739,13302,99,100,96,295,98.33333333333333,A+
196786,443269,91,94,85,270,90.0,A+
197156,563314,86,89,97,272,90.66666666666667,A+
197324,386439,93,94,90,277,92.33333333333333,A+
197351,1041131,97,92,86,275,91.66666666666667,A+
197475,638579,83,91,99,273,91.0,A+
197687,700264,82,92,99,273,91.0,A+
197761,911824,85,98,93,276,92.0,A+
197832,129604,84,95,93,272,90.66666666666667,A+
197944,273927,89,98,84,271,90.33333333333333,A+
197957,331339,92,83,95,270,90.0,A+
198126,749960,100,98,100,298,99.33333333333333,A+
198184,1020465,98,92,84,274,91.33333333333333,A+
198647,207877,98,90,93,281,93.66666666666667,A+
199379,468722,91,97,84,272,90.66666666666667,A+
199568,80043,95,97,84,276,92.0,A+
199829,676352,90,87,93,270,90.0,A+
200037,801165,89,98,86,273,91.0,A+
200215,192439,82,94,95,271,90.33333333333333,A+
200400,776238,97,92,95,284,94.66666666666667,A+
200584,660896,85,99,98,282,94.0,A+
200651,778782,96,88,96,280,93.33333333333333,A+
200658,1010383,100,97,81,278,92.66666666666667,A+
200738,785904,96,89,90,275,91.66666666666667,A+
200909,284156,97,93,80,270,90.0,A+
200926,125275,92,89,96,277,92.33333333333333,A+
201184,307683,88,98,92,278,92.66666666666667,A+
201212,280726,95,87,89,271,90.33333333333333,A+
201330,784113,94,80,97,271,90.33333333333333,A+
201448,548910,89,99,98,286,95.33333333333333,A+
201491,374742,93,93,84,270,90.0,A+
202103,555164,98,99,100,297,99.0,A+
202599,662387,90,86,97,273,91.0,A+
203018,436661,97,80,100,277,92.33333333333333,A+
203700,555647,89,100,98,287,95.66666666666667,A+
203757,349358,77,98,99,274,91.33333333333333,A+
203824,1011356,99,93,93,285,95.0,A+
204155,290753,96,93,84,273,91.0,A+
204173,26056,93,82,97,272,90.66666666666667,A+
204476,572498,78,96,99,273,91.0,A+
204709,613169,77,98,97,272,90.66666666666667,A+
204894,206451,100,95,78,273,91.0,A+
205786,706494,100,94,83,277,92.33333333333333,A+
205838,644834,92,90,100,282,94.0,A+
205954,253183,80,96,97,273,91.0,A+
205999,189412,92,97,94,283,94.33333333333333,A+
206024,721987,99,90,95,284,94.66666666666667,A+
206030,329150,87,96,96,279,93.0,A+
206035,417682,84,100,94,278,92.66666666666667,A+
206229,223632,100,100,81,281,93.66666666666667,A+
206363,309243,93,84,99,276,92.0,A+
206423,259291,95,85,100,280,93.33333333333333,A+
206684,589220,85,92,97,274,91.33333333333333,A+
206686,972067,96,80,95,271,90.33333333333333,A+
206728,613664,86,98,89,273,91.0,A+
206745,726114,100,96,85,281,93.66666666666667,A+
206807,329395,87,97,94,278,92.66666666666667,A+
207249,127122,91,87,97,275,91.66666666666667,A+
207454,66707,96,97,80,273,91.0,A+
207527,529607,98,96,99,293,97.66666666666667,A+
207778,488520,99,96,93,288,96.0,A+
207807,741821,99,94,80,273,91.0,A+
207992,422219,92,93,90,275,91.66666666666667,A+
208272,980810,92,98,94,284,94.66666666666667,A+
208294,522558,98,97,93,288,96.0,A+
208421,933144,90,86,99,275,91.66666666666667,A+
208699,203517,92,99,86,277,92.33333333333333,A+
208910,304290,86,92,95,273,91.0,A+
209001,928895,92,93,92,277,92.33333333333333,A+
209078,446187,95,76,99,270,90.0,A+
209184,635687,85,95,97,277,92.33333333333333,A+
209446,164198,83,94,97,274,91.33333333333333,A+
209497,95567,100,83,88,271,90.33333333333333,A+
209608,620708,77,97,98,272,90.66666666666667,A+
209651,871716,95,94,97,286,95.33333333333333,A+
209811,585374,84,87,99,270,90.0,A+
210108,147762,100,89,82,271,90.33333333333333,A+
210194,552467,88,97,85,270,90.0,A+
210236,456666,97,82,96,275,91.66666666666667,A+
210470,313510,95,90,86,271,90.33333333333333,A+
210541,1017941,96,83,98,277,92.33333333333333,A+
210691,387869,93,94,84,271,90.33333333333333,A+
210792,973717,98,88,92,278,92.66666666666667,A+
210912,184772,100,94,91,285,95.0,A+
211348,599797,77,97,99,273,91.0,A+
211552,204171,97,86,90,273,91.0,A+
211696,98233,95,99,93,287,95.66666666666667,A+
212158,140193,94,99,89,282,94.0,A+
212239,272282,96,90,84,270,90.0,A+
212295,674817,91,88,97,276,92.0,A+
212875,114490,85,96,95,276,92.0,A+
213061,870395,96,98,85,279,93.0,A+
213218,58253,87,96,98,281,93.66666666666667,A+
213219,565387,96,95,99,290,96.66666666666667,A+
213477,840149,86,91,93,270,90.0,A+
213826,99835,94,96,97,287,95.66666666666667,A+
213919,113835,94,98,86,278,92.66666666666667,A+
214150,381236,93,93,86,272,90.66666666666667,A+
214215,560953,96,94,82,272,90.66666666666667,A+
214285,141888,75,96,100,271,90.33333333333333,A+
214304,397671,75,98,100,273,91.0,A+
214342,98960,86,99,90,275,91.66666666666667,A+
214427,593971,86,94,100,280,93.33333333333333,A+
214697,196003,98,87,96,281,93.66666666666667,A+
214734,776030,98,93,91,282,94.0,A+
214830,383052,85,99,96,280,93.33333333333333,A+
215207,823719,97,96,80,273,91.0,A+
215478,839738,95,93,82,270,90.0,A+
216084,943165,98,82,92,272,90.66666666666667,A+
216259,497177,99,96,83,278,92.66666666666667,A+
216406,563149,95,91,84,270,90.0,A+
216412,673668,91,90,96,277,92.33333333333333,A+
216943,122096,99,82,100,281,93.66666666666667,A+
216972,58435,96,98,85,279,93.0,A+
217285,320003,94,90,88,272,90.66666666666667,A+
217414,309328,96,96,86,278,92.66666666666667,A+
217484,820963,97,97,95,289,96.33333333333333,A+
217486,16475,98,97,89,284,94.66666666666667,A+
217628,807616,79,98,97,274,91.33333333333333,A+
217800,164516,91,92,100,283,94.33333333333333,A+
217846,318463,86,92,95,273,91.0,A+
217859,722653,99,92,80,271,90.33333333333333,A+
217874,863859,87,97,92,276,92.0,A+
218000,1023786,99,95,93,287,95.66666666666667,A+
218316,102695,94,94,84,272,90.66666666666667,A+
218381,584511,94,90,86,270,90.0,A+
218678,141539,90,86,95,271,90.33333333333333,A+
218805,486882,100,98,96,294,98.0,A+
219117,739437,81,96,95,272,90.66666666666667,A+
219180,620053,86,99,90,275,91.66666666666667,A+
219267,7542,99,100,87,286,95.33333333333333,A+
219347,774354,90,98,82,270,90.0,A+
219508,551691,94,85,96,275,91.66666666666667,A+
219565,432521,92,97,97,286,95.33333333333333,A+
219941,37353,98,100,74,272,90.66666666666667,A+
220071,416344,97,79,98,274,91.33333333333333,A+
220160,513869,100,100,90,290,96.66666666666667,A+
220249,927214,99,83,98,280,93.33333333333333,A+
220301,327096,88,100,90,278,92.66666666666667,A+
220417,15833,95,86,98,279,93.0,A+
220681,748089,95,81,100,276,92.0,A+
221020,141092,100,87,90,277,92.33333333333333,A+
221087,642155,94,98,82,274,91.33333333333333,A+
221126,472728,89,90,93,272,90.66666666666667,A+
221441,12825,78,92,100,270,90.0,A+
221669,660437,91,89,93,273,91.0,A+
222005,533930,96,91,94,281,93.66666666666667,A+
222009,139900,91,88,98,277,92.33333333333333,A+
222129,253652,99,99,72,270,90.0,A+
222219,515906,87,87,99,273,91.0,A+
222503,685743,82,93,99,274,91.33333333333333,A+
222883,884359,95,99,80,274,91.33333333333333,A+
223067,301679,88,98,85,271,90.33333333333333,A+
223353,565392,97,99,78,274,91.33333333333333,A+
223361,148497,93,95,99,287,95.66666666666667,A+
223726,306888,97,99,87,283,94.33333333333333,A+
223755,359586,100,82,90,272,90.66666666666667,A+
224636,705198,92,96,88,276,92.0,A+
224833,62765,97,98,99,294,98.0,A+
225422,900746,90,83,97,270,90.0,A+
225603,594209,77,95,100,272,90.66666666666667,A+
225619,578330,94,88,90,272,90.66666666666667,A+
225728,650905,84,93,97,274,91.33333333333333,A+
225977,463348,100,94,87,281,93.66666666666667,A+
226203,554003,96,91,99,286,95.33333333333333,A+
226456,696021,93,99,88,280,93.33333333333333,A+
226531,205260,91,96,86,273,91.0,A+
227001,515636,81,100,89,270,90.0,A+
227152,1045974,95,84,91,270,90.0,A+
227181,888933,96,100,93,289,96.33333333333333,A+
227234,258569,90,99,88,277,92.33333333333333,A+
227238,548702,89,100,94,283,94.33333333333333,A+
227421,363989,85,96,98,279,93.0,A+
227611,917418,95,100,89,284,94.66666666666667,A+
227619,86384,77,97,96,270,90.0,A+
227661,815747,94,86,91,271,90.33333333333333,A+
227881,488795,91,98,88,277,92.33333333333333,A+
228045,357532,86,97,89,272,90.66666666666667,A+
228440,361537,84,89,99,272,90.66666666666667,A+
228595,975044,83,98,89,270,90.0,A+
228617,816425,97,98,76,271,90.33333333333333,A+
228640,832231,95,91,94,280,93.33333333333333,A+
228811,160254,91,90,93,274,91.33333333333333,A+
228878,286210,95,89,86,270,90.0,A+
229583,324790,95,94,84,273,91.0,A+
229848,73721,95,94,92,281,93.66666666666667,A+
229861,480725,97,87,94,278,92.66666666666667,A+
230218,851081,87,96,91,274,91.33333333333333,A+
230410,491173,99,96,76,271,90.33333333333333,A+
230577,88548,100,81,96,277,92.33333333333333,A+
230609,745349,100,96,93,289,96.33333333333333,A+
231003,104671,99,78,100,277,92.33333333333333,A+
231032,185707,91,93,92,276,92.0,A+
231489,772300,99,98,93,290,96.66666666666667,A+
231575,332703,100,79,98,277,92.33333333333333,A+
231614,488801,100,97,85,282,94.0,A+
231663,764744,72,100,100,272,90.66666666666667,A+
231686,518492,95,84,91,270,90.0,A+
231946,794501,98,96,91,285,95.0,A+
232338,121436,100,84,94,278,92.66666666666667,A+
232843,392474,84,96,93,273,91.0,A+
232888,430767,90,89,98,277,92.33333333333333,A+
232925,827180,98,100,85,283,94.33333333333333,A+
233434,296830,97,95,78,270,90.0,A+
233437,507724,100,100,87,287,95.66666666666667,A+
233517,898801,100,86,90,276,92.0,A+
234006,676712,93,96,92,281,93.66666666666667,A+
234204,573628,96,96,80,272,90.66666666666667,A+
234291,758152,97,89,88,274,91.33333333333333,A+
234393,507682,90,99,96,285,95.0,A+
234616,635339,85,95,97,277,92.33333333333333,A+
234677,972225,93,100,93,286,95.33333333333333,A+
234755,898557,85,96,97,278,92.66666666666667,A+
234914,404072,94,98,95,287,95.66666666666667,A+
235580,495050,100,98,89,287,95.66666666666667,A+
235646,725613,97,86,90,273,91.0,A+
235648,476469,90,95,90,275,91.66666666666667,A+
236120,177569,98,85,90,273,91.0,A+
236186,57530,97,100,81,278,92.66666666666667,A+
236229,490147,81,95,97,273,91.0,A+
236234,750241,100,100,92,292,97.33333333333333,A+
236334,792716,89,98,100,287,95.66666666666667,A+
236478,747985,96,82,98,276,92.0,A+
236776,273230,89,99,84,272,90.66666666666667,A+
236826,251330,72,100,98,270,90.0,A+
236909,27334,98,99,100,297,99.0,A+
236965,241425,98,91,97,286,95.33333333333333,A+
237072,180083,90,90,100,280,93.33333333333333,A+
237434,525168,89,96,85,270,90.0,A+
237514,739505,96,84,98,278,92.66666666666667,A+
237525,995507,91,99,84,274,91.33333333333333,A+
237553,280280,89,98,90,277,92.33333333333333,A+
237702,907251,93,93,98,284,94.66666666666667,A+
237776,506318,97,92,88,277,92.33333333333333,A+
237808,445336,93,100,91,284,94.66666666666667,A+
237811,612612,78,100,93,271,90.33333333333333,A+
237816,927666,99,82,100,281,93.66666666666667,A+
238360,621405,76,96,98,270,90.0,A+
238445,246566,99,99,72,270,90.0,A+
238495,127659,94,98,86,278,92.66666666666667,A+
238780,726066,82,95,97,274,91.33333333333333,A+
238973,283943,96,90,96,282,94.0,A+
239126,452521,83,99,95,277,92.33333333333333,A+
239169,1036460,99,98,91,288,96.0,A+
239280,1765,95,86,100,281,93.66666666666667,A+
239312,784302,97,92,86,275,91.66666666666667,A+
239397,577193,97,100,87,284,94.66666666666667,A+
239492,752704,97,87,86,270,90.0,A+
239505,349810,92,86,95,273,91.0,A+
239976,745269,97,88,86,271,90.33333333333333,A+
240300,161373,99,86,98,283,94.33333333333333,A+
240430,546188,97,95,84,276,92.0,A+
240789,662528,91,86,93,270,90.0,A+
241112,671161,93,95,88,276,92.0,A+
241363,50995,88,99,88,275,91.66666666666667,A+
241566,784791,97,92,82,271,90.33333333333333,A+
241795,1782,99,100,79,278,92.66666666666667,A+
241864,561156,87,94,89,270,90.0,A+
241908,262372,97,93,90,280,93.33333333333333,A+
241952,580391,86,94,97,277,92.33333333333333,A+
242283,466296,95,78,97,270,90.0,A+
242286,164656,91,93,96,280,93.33333333333333,A+
242335,138011,98,80,100,278,92.66666666666667,A+
242397,315773,93,85,95,273,91.0,A+
242493,203267,83,99,91,273,91.0,A+
242574,878074,95,98,82,275,91.66666666666667,A+
242605,190250,92,97,90,279,93.0,A+
243154,334255,96,98,95,289,96.33333333333333,A+
243268,780316,80,97,97,274,91.33333333333333,A+
243426,377708,85,97,95,277,92.33333333333333,A+
243439,572712,87,95,100,282,94.0,A+
243618,9737,98,97,89,284,94.66666666666667,A+
243909,768131,80,95,95,270,90.0,A+
244186,46494,96,96,80,272,90.66666666666667,A+
244344,816554,87,95,96,278,92.66666666666667,A+
244499,491094,89,94,92,275,91.66666666666667,A+
244818,195832,98,89,86,273,91.0,A+
244889,173234,97,80,95,272,90.66666666666667,A+
244938,549441,98,100,85,283,94.33333333333333,A+
245100,553721,87,94,89,270,90.0,A+
245233,710327,83,100,87,270,90.0,A+
245663,655979,94,98,82,274,91.33333333333333,A+
245678,641972,100,86,90,276,92.0,A+
245791,584371,94,89,90,273,91.0,A+
245856,482155,97,87,88,272,90.66666666666667,A+
245988,784718,96,90,94,280,93.33333333333333,A+
246063,687596,91,89,98,278,92.66666666666667,A+
246140,467182,83,99,91,273,91.0,A+
246312,85234,77,99,95,271,90.33333333333333,A+
246586,505084,95,81,99,275,91.66666666666667,A+
246763,293328,94,86,100,280,93.33333333333333,A+
247281,204600,100,94,97,291,97.0,A+
247359,881829,84,91,97,272,90.66666666666667,A+
247438,5739,94,81,95,270,90.0,A+
247489,106805,76,97,100,273,91.0,A+
247502,114526,85,97,89,271,90.33333333333333,A+
247676,454862,91,96,90,277,92.33333333333333,A+
247747,70218,100,79,92,271,90.33333333333333,A+
247896,502785,96,85,96,277,92.33333333333333,A+
248015,261430,97,93,93,283,94.33333333333333,A+
248073,445929,92,99,88,279,93.0,A+
248247,502657,98,95,99,292,97.33333333333333,A+
248251,847204,94,90,96,280,93.33333333333333,A+
248385,632557,95,99,95,289,96.33333333333333,A+
248999,558055,89,99,84,272,90.66666666666667,A+
249008,155333,99,85,98,282,94.0,A+
249131,31172,97,98,78,273,91.0,A+
249474,30495,79,97,99,275,91.66666666666667,A+
249647,1007052,89,90,95,274,91.33333333333333,A+
249819,147127,91,89,93,273,91.0,A+
250214,391178,91,87,93,271,90.33333333333333,A+
250710,357037,77,97,96,270,90.0,A+
251434,1043742,96,86,96,278,92.66666666666667,A+
251464,356284,96,99,82,277,92.33333333333333,A+
251668,49326,97,99,93,289,96.33333333333333,A+
251722,461001,82,97,95,274,91.33333333333333,A+
251725,983139,97,85,90,272,90.66666666666667,A+
251967,659141,83,91,99,273,91.0,A+
252131,863755,87,98,89,274,91.33333333333333,A+
252385,662918,100,87,84,271,90.33333333333333,A+
252472,33943,93,80,99,272,90.66666666666667,A+
252501,283484,87,92,97,276,92.0,A+
252568,960180,93,99,86,278,92.66666666666667,A+
252625,162534,93,98,82,273,91.0,A+
252685,785311,96,89,92,277,92.33333333333333,A+
252950,758152,82,100,93,275,91.66666666666667,A+
253016,926272,99,84,100,283,94.33333333333333,A+
253241,669724,99,85,92,276,92.0,A+
253311,1000889,100,98,96,294,98.0,A+
253779,814842,95,88,88,271,90.33333333333333,A+
253793,498015,99,95,78,272,90.66666666666667,A+
253982,841855,85,88,99,272,90.66666666666667,A+
254418,724335,100,97,91,288,96.0,A+
254512,489596,90,96,90,276,92.0,A+
254598,761747,89,94,92,275,91.66666666666667,A+
254633,682851,99,86,92,277,92.33333333333333,A+
254952,659838,98,79,93,270,90.0,A+
255249,96202,94,94,82,270,90.0,A+
255827,834426,94,88,96,278,92.66666666666667,A+
255961,1006886,98,92,82,272,90.66666666666667,A+
256214,453541,93,100,78,271,90.33333333333333,A+
256274,782419,98,94,91,283,94.33333333333333,A+
256510,974629,91,96,98,285,95.0,A+
256684,576093,86,91,97,274,91.33333333333333,A+
256721,35814,97,97,99,293,97.66666666666667,A+
256908,487683,99,97,98,294,98.0,A+
257812,167982,93,100,84,277,92.33333333333333,A+
257981,690634,99,85,92,276,92.0,A+
258294,864862,77,95,100,272,90.66666666666667,A+
258541,965133,99,90,91,280,93.33333333333333,A+
258771,446834,92,97,92,281,93.66666666666667,A+
258932,522539,87,88,97,272,90.66666666666667,A+
258945,584641,100,76,100,276,92.0,A+
259000,805518,87,91,95,273,91.0,A+
259117,494897,97,87,94,278,92.66666666666667,A+
259147,103974,99,79,100,278,92.66666666666667,A+
259582,523493,89,97,94,280,93.33333333333333,A+
259684,919686,94,99,78,271,90.33333333333333,A+
259735,804222,94,82,95,271,90.33333333333333,A+
259912,672268,98,81,94,273,91.0,A+
260281,871508,95,95,93,283,94.33333333333333,A+
260345,62233,95,91,90,276,92.0,A+
260443,148111,85,99,87,271,90.33333333333333,A+
260569,410694,75,100,99,274,91.33333333333333,A+
260749,356248,95,98,89,282,94.0,A+
261233,111904,92,88,98,278,92.66666666666667,A+
261369,720728,90,93,94,277,92.33333333333333,A+
261408,776935,97,91,94,282,94.0,A+
261422,495148,90,97,94,281,93.66666666666667,A+
261745,165696,82,92,99,273,91.0,A+
261960,99468,83,87,100,270,90.0,A+
262103,102451,94,94,86,274,91.33333333333333,A+
262297,693490,97,80,100,277,92.33333333333333,A+
262492,394180,83,92,99,274,91.33333333333333,A+
262543,693282,97,81,96,274,91.33333333333333,A+
262555,142835,84,95,95,274,91.33333333333333,A+
262561,437443,100,91,86,277,92.33333333333333,A+
262806,335185,93,87,94,274,91.33333333333333,A+
262823,523848,98,96,91,285,95.0,A+
263071,141483,94,98,86,278,92.66666666666667,A+
263486,977417,90,92,98,280,93.33333333333333,A+
263532,725369,82,96,97,275,91.66666666666667,A+
264037,462125,92,98,80,270,90.0,A+
264230,124230,92,91,96,279,93.0,A+
264282,284774,87,90,95,272,90.66666666666667,A+
264534,1047692,97,91,96,284,94.66666666666667,A+
264752,840956,79,100,97,276,92.0,A+
265032,157772,98,82,98,278,92.66666666666667,A+
265085,224135,72,98,100,270,90.0,A+
265638,757565,91,100,92,283,94.33333333333333,A+
265739,1045729,95,84,93,272,90.66666666666667,A+
265834,419155,94,100,78,272,90.66666666666667,A+
266008,748828,89,92,96,277,92.33333333333333,A+
266292,75880,94,90,100,284,94.66666666666667,A+
266542,711276,100,94,99,293,97.66666666666667,A+
266563,690977,74,96,100,270,90.0,A+
266690,946626,99,86,96,281,93.66666666666667,A+
266720,197091,91,97,92,280,93.33333333333333,A+
266780,282304,96,92,99,287,95.66666666666667,A+
266995,830244,96,94,97,287,95.66666666666667,A+
267009,108345,100,84,88,272,90.66666666666667,A+
267231,498639,98,92,91,281,93.66666666666667,A+
267327,69765,85,90,95,270,90.0,A+
267485,948124,98,83,98,279,93.0,A+
268051,798230,96,91,88,275,91.66666666666667,A+
268422,1012083,90,94,89,273,91.0,A+
268794,22008,86,89,97,272,90.66666666666667,A+
268860,209002,100,97,100,297,99.0,A+
269053,182399,93,100,82,275,91.66666666666667,A+
269162,137699,98,81,94,273,91.0,A+
269690,933327,84,98,91,273,91.0,A+
269693,236711,97,90,88,275,91.66666666666667,A+
269867,1019475,95,82,93,270,90.0,A+
270054,892033,94,95,99,288,96.0,A+
270144,564689,89,100,82,271,90.33333333333333,A+
270184,304150,86,92,99,277,92.33333333333333,A+
270199,285245,98,99,93,290,96.66666666666667,A+
270239,669803,93,98,82,273,91.0,A+
270278,168600,99,87,94,280,93.33333333333333,A+
270564,964430,91,92,94,277,92.33333333333333,A+
270753,478915,98,91,86,275,91.66666666666667,A+
270775,994560,83,100,89,272,90.66666666666667,A+
270970,397280,97,76,99,272,90.66666666666667,A+
271319,982130,83,98,89,270,90.0,A+
271425,376461,95,99,89,283,94.33333333333333,A+
271517,700056,82,93,95,270,90.0,A+
271663,656940,75,95,100,270,90.0,A+
271694,676774,99,84,98,281,93.66666666666667,A+
271807,552541,97,95,91,283,94.33333333333333,A+
272132,496792,99,95,89,283,94.33333333333333,A+
272184,1036454,90,98,94,282,94.0,A+
272383,963489,91,92,96,279,93.0,A+
274132,57690,94,87,92,273,91.0,A+
274565,670079,93,95,94,282,94.0,A+
274720,525095,88,94,98,280,93.33333333333333,A+
274792,723381,98,88,94,280,93.33333333333333,A+
274810,460304,83,98,95,276,92.0,A+
274844,42520,98,100,85,283,94.33333333333333,A+
275336,1003743,91,97,86,274,91.33333333333333,A+
275343,346178,100,80,98,278,92.66666666666667,A+
275729,52426,96,93,99,288,96.0,A+
275836,600366,95,95,97,287,95.66666666666667,A+
276086,876118,95,97,99,291,97.0,A+
276294,944431,84,100,100,284,94.66666666666667,A+
276336,47009,86,93,93,272,90.66666666666667,A+
276668,460402,73,98,100,271,90.33333333333333,A+
276813,622211,100,84,92,276,92.0,A+
276931,896105,99,79,93,271,90.33333333333333,A+
276991,961985,83,95,97,275,91.66666666666667,A+
277057,482797,100,97,79,276,92.0,A+
277158,340174,100,80,92,272,90.66666666666667,A+
277529,798506,96,89,100,285,95.0,A+
277618,561425,93,81,99,273,91.0,A+
277724,362460,95,97,99,291,97.0,A+
277760,1037213,95,85,100,280,93.33333333333333,A+
277900,425123,93,99,90,282,94.0,A+
278246,382594,77,100,97,274,91.33333333333333,A+
278279,847485,94,91,88,273,91.0,A+
278593,863308,96,99,85,280,93.33333333333333,A+
278945,520387,97,92,86,275,91.66666666666667,A+
278949,418129,75,99,98,272,90.66666666666667,A+
279025,99064,86,99,92,277,92.33333333333333,A+
279454,450007,91,94,85,270,90.0,A+
279568,610130,85,92,97,274,91.33333333333333,A+
279886,773542,96,85,98,279,93.0,A+
280091,571899,85,86,99,270,90.0,A+
280167,568291,98,100,100,298,99.33333333333333,A+
280241,169988,89,85,97,271,90.33333333333333,A+
280403,20859,87,90,95,272,90.66666666666667,A+
281126,916709,92,91,90,273,91.0,A+
281156,459356,74,99,100,273,91.0,A+
281178,731654,97,87,90,274,91.33333333333333,A+
281267,993344,92,99,97,288,96.0,A+
281351,822589,78,96,99,273,91.0,A+
281528,509455,96,87,88,271,90.33333333333333,A+
281545,800597,95,86,100,281,93.66666666666667,A+
281700,146791,94,99,93,286,95.33333333333333,A+
281749,648704,91,86,93,270,90.0,A+
281848,642419,91,85,95,271,90.33333333333333,A+
282079,613487,86,96,100,282,94.0,A+
282160,782908,98,94,86,278,92.66666666666667,A+
282673,179740,99,90,97,286,95.33333333333333,A+
282745,681744,94,100,86,280,93.33333333333333,A+
282898,140500,84,98,98,280,93.33333333333333,A+
282994,185890,100,95,79,274,91.33333333333333,A+
283076,529716,99,99,81,279,93.0,A+
283462,80880,95,96,80,271,90.33333333333333,A+
283815,467048,91,98,92,281,93.66666666666667,A+
284228,490012,90,94,98,282,94.0,A+
284360,521188,97,90,88,275,91.66666666666667,A+
284481,129213,90,84,97,271,90.33333333333333,A+
284682,45797,97,97,80,274,91.33333333333333,A+
284905,267911,95,84,95,274,91.33333333333333,A+
285052,198766,91,96,84,271,90.33333333333333,A+
285111,449665,100,94,83,277,92.33333333333333,A+
285210,398674,97,74,99,270,90.0,A+
285334,122065,100,85,86,271,90.33333333333333,A+
285748,410664,100,88,97,285,95.0,A+
285874,3654,88,95,98,281,93.66666666666667,A+
285939,933572,84,98,89,271,90.33333333333333,A+
286150,922359,83,92,99,274,91.33333333333333,A+
286277,1037786,99,97,83,279,93.0,A+
286855,613461,96,99,82,277,92.33333333333333,A+
287137,561859,96,92,86,274,91.33333333333333,A+
287338,856466,96,99,83,278,92.66666666666667,A+
287389,438904,99,87,94,280,93.33333333333333,A+
287444,495001,96,86,96,278,92.66666666666667,A+
287507,607446,86,95,100,281,93.66666666666667,A+
287647,155307,93,98,86,277,92.33333333333333,A+
287934,76833,96,99,97,292,97.33333333333333,A+
288078,870310,92,86,98,276,92.0,A+
288145,655441,91,87,93,271,90.33333333333333,A+
288425,126884,100,86,97,283,94.33333333333333,A+
288574,403369,100,89,93,282,94.0,A+
289352,835067,97,99,87,283,94.33333333333333,A+
289506,939436,84,97,100,281,93.66666666666667,A+
289895,826691,98,100,89,287,95.66666666666667,A+
290564,779032,90,98,96,284,94.66666666666667,A+
291351,380919,92,90,100,282,94.0,A+
291487,165659,97,80,100,277,92.33333333333333,A+
291566,733464,96,83,98,277,92.33333333333333,A+
291676,647524,100,87,95,282,94.0,A+
291764,536063,89,99,90,278,92.66666666666667,A+
291765,1045937,95,83,97,275,91.66666666666667,A+
291931,313535,100,77,98,275,91.66666666666667,A+
292564,118746,92,88,100,280,93.33333333333333,A+
292596,803011,88,96,87,271,90.33333333333333,A+
292948,629969,94,96,80,270,90.0,A+
293664,83528,94,92,84,270,90.0,A+
293693,222851,82,99,99,280,93.33333333333333,A+
294057,482051,97,87,86,270,90.0,A+
294110,681243,91,90,91,272,90.66666666666667,A+
294176,721639,99,90,95,284,94.66666666666667,A+
294267,415169,92,94,84,270,90.0,A+
294404,125129,98,79,98,275,91.66666666666667,A+
294645,310758,96,95,80,271,90.33333333333333,A+
294702,294348,88,98,88,274,91.33333333333333,A+
294742,719468,82,95,93,270,90.0,A+
294815,683627,93,98,82,273,91.0,A+
295140,95567,85,94,93,272,90.66666666666667,A+
295155,571140,79,99,93,271,90.33333333333333,A+
295225,487004,88,89,95,272,90.66666666666667,A+
295329,603331,94,93,86,273,91.0,A+
295629,681243,75,100,97,272,90.66666666666667,A+
295689,1003401,100,97,83,280,93.33333333333333,A+
295881,836309,94,86,91,271,90.33333333333333,A+
295948,461099,73,97,100,270,90.0,A+
296270,967078,89,87,97,273,91.0,A+
296883,124817,99,80,91,270,90.0,A+
297235,741430,90,94,89,273,91.0,A+
297341,377703,76,97,98,271,90.33333333333333,A+
297660,616978,93,91,96,280,93.33333333333333,A+
298301,456610,100,93,87,280,93.33333333333333,A+
298473,562391,98,100,95,293,97.66666666666667,A+
298496,230125,100,100,83,283,94.33333333333333,A+
298555,144749,98,80,100,278,92.66666666666667,A+
298735,235176,98,91,93,282,94.0,A+
299575,439113,98,86,98,282,94.0,A+
299706,909971,92,91,90,273,91.0,A+
299923,267422,94,84,100,278,92.66666666666667,A+
300186,784346,99,99,100,298,99.33333333333333,A+
300244,308026,94,87,89,270,90.0,A+
300331,188996,92,100,86,278,92.66666666666667,A+
300524,580385,93,84,95,272,90.66666666666667,A+
300695,679806,98,80,96,274,91.33333333333333,A+
300711,39304,97,96,78,271,90.33333333333333,A+
300886,312813,95,91,86,272,90.66666666666667,A+
301527,148179,84,97,95,276,92.0,A+
302040,307225,79,99,93,271,90.33333333333333,A+
302190,204624,82,96,97,275,91.66666666666667,A+
302285,245436,81,99,91,271,90.33333333333333,A+
303315,987474,83,100,89,272,90.66666666666667,A+
303386,41218,95,92,88,275,91.66666666666667,A+
303521,644803,93,93,86,272,90.66666666666667,A+
303637,517208,89,95,96,280,93.33333333333333,A+
303804,403858,100,89,88,277,92.33333333333333,A+
304014,1014010,91,99,99,289,96.33333333333333,A+
304108,105857,83,87,100,270,90.0,A+
304360,196046,92,98,92,282,94.0,A+
304462,15271,86,88,97,271,90.33333333333333,A+
304488,388598,92,90,98,280,93.33333333333333,A+
304607,331247,95,93,92,280,93.33333333333333,A+
304768,953749,83,97,95,275,91.66666666666667,A+
305287,660693,94,99,91,284,94.66666666666667,A+
305618,757743,99,97,100,296,98.66666666666667,A+
306024,528342,96,89,96,281,93.66666666666667,A+
306050,316079,99,73,99,271,90.33333333333333,A+
306138,161342,84,100,89,273,91.0,A+
306172,940726,99,85,92,276,92.0,A+
306311,7958,98,98,95,291,97.0,A+
306421,959685,84,99,93,276,92.0,A+
306594,495080,91,99,86,276,92.0,A+
306760,226108,100,98,75,273,91.0,A+
307044,414039,89,84,97,270,90.0,A+
307216,682258,99,87,94,280,93.33333333333333,A+
307399,1045497,98,94,95,287,95.66666666666667,A+
307488,469799,90,93,98,281,93.66666666666667,A+
307518,567753,87,93,93,273,91.0,A+
307522,524122,89,97,86,272,90.66666666666667,A+
307557,1031116,98,95,91,284,94.66666666666667,A+
307958,55807,94,89,96,279,93.0,A+
308032,50194,88,100,86,274,91.33333333333333,A+
308054,755884,98,90,99,287,95.66666666666667,A+
308105,583185,94,90,94,278,92.66666666666667,A+
308185,912870,85,97,93,275,91.66666666666667,A+
308267,351412,91,83,99,273,91.0,A+
308444,329052,96,97,91,284,94.66666666666667,A+
308541,932386,84,98,93,275,91.66666666666667,A+
308829,213429,99,92,97,288,96.0,A+
309247,689313,100,90,80,270,90.0,A+
309621,509070,96,87,94,277,92.33333333333333,A+
309774,275138,79,95,96,270,90.0,A+
309871,832800,97,100,98,295,98.33333333333333,A+
309980,648508,94,97,88,279,93.0,A+
309993,252583,87,86,97,270,90.0,A+
310009,116025,84,95,91,270,90.0,A+
310181,740593,90,94,94,278,92.66666666666667,A+
310469,184515,82,95,99,276,92.0,A+
310659,442181,98,84,90,272,90.66666666666667,A+
311049,538441,98,97,78,273,91.0,A+
311182,426938,93,99,78,270,90.0,A+
311294,411397,84,98,95,277,92.33333333333333,A+
311489,664276,84,94,95,273,91.0,A+
311570,901075,94,95,82,271,90.33333333333333,A+
311649,455039,92,98,80,270,90.0,A+
311713,686274,92,94,86,272,90.66666666666667,A+
312223,169131,93,98,86,277,92.33333333333333,A+
312742,613565,96,98,84,278,92.66666666666667,A+
313058,958572,100,92,80,272,90.66666666666667,A+
313163,22998,89,99,88,276,92.0,A+
313185,503775,99,96,87,282,94.0,A+
313313,111207,92,89,98,279,93.0,A+
313554,388383,99,81,92,272,90.66666666666667,A+
313879,430455,91,91,91,273,91.0,A+
314052,107013,91,85,99,275,91.66666666666667,A+
314811,830372,78,95,98,271,90.33333333333333,A+
314815,724189,91,97,98,286,95.33333333333333,A+
315061,660834,94,100,87,281,93.66666666666667,A+
315197,330691,95,95,88,278,92.66666666666667,A+
315596,656359,93,94,96,283,94.33333333333333,A+
315829,302994,93,83,95,271,90.33333333333333,A+
316009,885919,85,95,93,273,91.0,A+
316408,41891,98,100,93,291,97.0,A+
316679,110302,93,91,94,278,92.66666666666667,A+
316845,188746,83,100,91,274,91.33333333333333,A+
317038,466032,99,90,84,273,91.0,A+
317135,580886,96,94,90,280,93.33333333333333,A+
317197,154464,100,88,88,276,92.0,A+
317199,345658,85,93,93,271,90.33333333333333,A+
317315,446437,89,87,99,275,91.66666666666667,A+
317691,772025,100,100,81,281,93.66666666666667,A+
317962,741509,100,96,74,270,90.0,A+
318119,518088,98,96,83,277,92.33333333333333,A+
318166,1022532,100,98,89,287,95.66666666666667,A+
318185,900263,99,82,98,279,93.0,A+
318558,856883,96,97,91,284,94.66666666666667,A+
318636,112637,92,88,91,271,90.33333333333333,A+
318831,718032,89,86,97,272,90.66666666666667,A+
319391,697451,93,98,82,273,91.0,A+
319448,193881,100,93,82,275,91.66666666666667,A+
319858,363297,95,97,95,287,95.66666666666667,A+
320417,173283,100,91,89,280,93.33333333333333,A+
320962,556546,95,87,100,282,94.0,A+
321692,885320,92,85,93,270,90.0,A+
321726,668513,94,99,84,277,92.33333333333333,A+
321816,788796,79,95,97,271,90.33333333333333,A+
321889,211967,100,95,89,284,94.66666666666667,A+
321904,701248,91,92,87,270,90.0,A+
321984,341017,94,90,90,274,91.33333333333333,A+
322357,306730,70,100,100,270,90.0,A+
322597,976120,97,83,98,278,92.66666666666667,A+
322709,634880,91,86,93,270,90.0,A+
322978,246249,99,96,87,282,94.0,A+
323051,51056,94,87,94,275,91.66666666666667,A+
323117,238802,96,87,88,271,90.33333333333333,A+
323207,739381,100,97,81,278,92.66666666666667,A+
323564,385345,91,85,97,273,91.0,A+
323684,683174,93,99,80,272,90.66666666666667,A+
323719,707925,93,100,99,292,97.33333333333333,A+
323783,301050,88,97,94,279,93.0,A+
323818,942682,91,92,98,281,93.66666666666667,A+
323849,424041,93,99,97,289,96.33333333333333,A+
323924,896417,98,77,100,275,91.66666666666667,A+
323948,108345,85,95,93,273,91.0,A+
323994,919913,90,85,97,272,90.66666666666667,A+
324339,788772,97,93,97,287,95.66666666666667,A+
324354,712902,97,82,98,277,92.33333333333333,A+
324374,876344,99,77,95,271,90.33333333333333,A+
324628,24766,94,83,99,276,92.0,A+
324630,240905,98,94,87,279,93.0,A+
324908,166949,97,79,97,273,91.0,A+
324918,492819,100,100,94,294,98.0,A+
325188,199709,99,91,99,289,96.33333333333333,A+
325276,961704,98,83,100,281,93.66666666666667,A+
325477,293933,97,96,97,290,96.66666666666667,A+
326091,674750,91,90,89,270,90.0,A+
326339,871929,95,97,80,272,90.66666666666667,A+
326349,1019035,98,93,91,282,94.0,A+
326432,28232,96,91,84,271,90.33333333333333,A+
326470,404592,85,100,87,272,90.66666666666667,A+
326831,183652,92,97,86,275,91.66666666666667,A+
326868,134074,100,85,98,283,94.33333333333333,A+
327177,844857,92,82,99,273,91.0,A+
327354,279124,96,90,86,272,90.66666666666667,A+
328149,717524,92,99,86,277,92.33333333333333,A+
328424,260910,98,96,83,277,92.33333333333333,A+
328472,26973,95,90,100,285,95.0,A+
328575,293657,98,99,85,282,94.0,A+
328609,214755,98,91,88,277,92.33333333333333,A+
328630,63835,78,99,99,276,92.0,A+
329563,287855,88,98,86,272,90.66666666666667,A+
329822,281331,97,96,87,280,93.33333333333333,A+
329958,738465,90,96,100,286,95.33333333333333,A+
330420,936495,98,80,100,278,92.66666666666667,A+
330531,400783,92,92,100,284,94.66666666666667,A+
330560,913297,94,98,78,270,90.0,A+
330570,690953,92,94,100,286,95.33333333333333,A+
330796,725589,100,94,95,289,96.33333333333333,A+
331072,834609,88,100,88,276,92.0,A+
331638,76711,100,79,94,273,91.0,A+
331894,545143,97,97,85,279,93.0,A+
332256,86500,95,96,93,284,94.66666666666667,A+
332370,473815,98,89,84,271,90.33333333333333,A+
332557,765727,97,89,84,270,90.0,A+
332591,713740,81,93,99,273,91.0,A+
332781,742445,98,91,93,282,94.0,A+
332796,49974,94,87,100,281,93.66666666666667,A+
332995,655001,94,98,90,282,94.0,A+
333362,822013,98,100,74,272,90.66666666666667,A+
333446,191956,91,94,96,281,93.66666666666667,A+
333561,188152,99,90,88,277,92.33333333333333,A+
333820,489590,97,86,88,271,90.33333333333333,A+
334141,417890,84,99,98,281,93.66666666666667,A+
334146,267227,98,95,95,288,96.0,A+
334228,613621,77,97,99,273,91.0,A+
334356,81566,100,81,98,279,93.0,A+
334470,562452,96,92,84,272,90.66666666666667,A+
334616,200925,90,92,91,273,91.0,A+
335185,305550,95,89,96,280,93.33333333333333,A+
335302,618231,93,89,100,282,94.0,A+
335370,487365,91,98,94,283,94.33333333333333,A+
335385,176970,74,96,100,270,90.0,A+
335609,456568,90,93,96,279,93.0,A+
335697,469934,81,94,97,272,90.66666666666667,A+
335889,751225,94,77,99,270,90.0,A+
336026,250266,99,99,96,294,98.0,A+
336335,195398,95,77,99,271,90.33333333333333,A+
336479,746487,96,84,96,276,92.0,A+
336779,994169,73,100,98,271,90.33333333333333,A+
336799,182955,92,98,86,276,92.0,A+
336801,256227,97,92,88,277,92.33333333333333,A+
337538,478878,98,90,92,280,93.33333333333333,A+
337603,197306,100,95,93,288,96.0,A+
337664,637117,100,84,86,270,90.0,A+
337733,963690,97,81,98,276,92.0,A+
337786,586224,87,97,94,278,92.66666666666667,A+
337970,508317,100,99,85,284,94.66666666666667,A+
337978,431372,93,99,95,287,95.66666666666667,A+
337989,931450,94,99,93,286,95.33333333333333,A+
338235,800156,98,97,97,292,97.33333333333333,A+
338469,357593,92,85,95,272,90.66666666666667,A+
338662,164418,100,92,95,287,95.66666666666667,A+
339164,295644,97,96,82,275,91.66666666666667,A+
339490,104017,93,90,96,279,93.0,A+
339686,756097,98,93,82,273,91.0,A+
340016,441564,100,93,97,290,96.66666666666667,A+
340167,605177,78,100,93,271,90.33333333333333,A+
340256,414503,92,93,98,283,94.33333333333333,A+
340295,920897,99,85,86,270,90.0,A+
340331,814567,88,97,98,283,94.33333333333333,A+
340398,1019476,80,92,98,270,90.0,A+
340490,952324,93,98,99,290,96.66666666666667,A+
340491,406818,99,83,98,280,93.33333333333333,A+
340639,193307,96,80,100,276,92.0,A+
340658,226342,90,94,96,280,93.33333333333333,A+
341035,74932,100,80,100,280,93.33333333333333,A+
341191,558649,96,94,99,289,96.33333333333333,A+
341252,932600,93,97,95,285,95.0,A+
341267,785654,72,100,100,272,90.66666666666667,A+
341897,248401,88,92,98,278,92.66666666666667,A+
341899,811705,96,92,88,276,92.0,A+
342221,317564,95,94,88,277,92.33333333333333,A+
342222,987646,82,98,99,279,93.0,A+
342857,600781,86,97,87,270,90.0,A+
343021,390830,76,98,98,272,90.66666666666667,A+
343025,711831,92,97,86,275,91.66666666666667,A+
343081,266107,89,98,90,277,92.33333333333333,A+
343283,892100,85,97,89,271,90.33333333333333,A+
343316,410254,94,100,91,285,95.0,A+
343528,368030,99,79,96,274,91.33333333333333,A+
343747,329785,96,97,84,277,92.33333333333333,A+
343841,252955,99,100,73,272,90.66666666666667,A+
343967,711275,92,98,82,272,90.66666666666667,A+
344039,350012,98,75,97,270,90.0,A+
344095,639667,92,90,89,271,90.33333333333333,A+
344303,164552,92,93,94,279,93.0,A+
344726,418129,90,88,93,271,90.33333333333333,A+
344836,430425,84,100,100,284,94.66666666666667,A+
344993,297699,96,92,88,276,92.0,A+
345374,300431,98,100,79,277,92.33333333333333,A+
345416,1038955,95,83,100,278,92.66666666666667,A+
345445,560397,97,96,78,271,90.33333333333333,A+
345527,493889,82,100,93,275,91.66666666666667,A+
346000,689002,93,97,97,287,95.66666666666667,A+
346222,290576,96,91,94,281,93.66666666666667,A+
346245,719615,91,96,86,273,91.0,A+
346652,608320,86,96,89,271,90.33333333333333,A+
346753,326705,79,100,99,278,92.66666666666667,A+
346828,779271,81,99,97,277,92.33333333333333,A+
346854,703553,83,98,93,274,91.33333333333333,A+
346941,914306,93,95,84,272,90.66666666666667,A+
346994,2370,98,96,97,291,97.0,A+
347098,1030205,90,98,90,278,92.66666666666667,A+
347499,377256,85,98,93,276,92.0,A+
347656,793895,95,87,94,276,92.0,A+
347716,511900,89,94,89,272,90.66666666666667,A+
347879,877995,86,96,98,280,93.33333333333333,A+
348265,142975,84,96,91,271,90.33333333333333,A+
348920,726866,97,83,94,274,91.33333333333333,A+
349277,519060,97,92,95,284,94.66666666666667,A+
349679,336536,99,74,97,270,90.0,A+
349736,674610,75,100,99,274,91.33333333333333,A+
349738,271647,87,89,95,271,90.33333333333333,A+
349869,687449,97,79,99,275,91.66666666666667,A+
350855,285942,98,98,93,289,96.33333333333333,A+
350862,719530,88,83,99,270,90.0,A+
351027,88585,85,93,95,273,91.0,A+
351205,210805,97,87,88,272,90.66666666666667,A+
351322,722086,89,90,100,279,93.0,A+
351541,471370,90,93,87,270,90.0,A+
351766,1025320,98,94,89,281,93.66666666666667,A+
352051,843848,78,96,98,272,90.66666666666667,A+
352256,1036429,100,100,77,277,92.33333333333333,A+
352499,529668,80,99,93,272,90.66666666666667,A+
352804,521842,87,89,97,273,91.0,A+
353029,1028518,88,88,99,275,91.66666666666667,A+
353041,208298,99,92,80,271,90.33333333333333,A+
353185,339171,94,93,88,275,91.66666666666667,A+
353413,1012926,99,93,82,274,91.33333333333333,A+
353659,282689,97,93,93,283,94.33333333333333,A+
353902,147824,75,98,98,271,90.33333333333333,A+
354023,844587,87,95,89,271,90.33333333333333,A+
354045,556350,98,98,95,291,97.0,A+
354105,1019580,80,92,100,272,90.66666666666667,A+
354482,186374,99,91,95,285,95.0,A+
354762,696529,89,86,99,274,91.33333333333333,A+
355247,235476,95,80,99,274,91.33333333333333,A+
355535,809334,97,94,97,288,96.0,A+
355949,887765,100,82,90,272,90.66666666666667,A+
355970,182559,74,98,98,270,90.0,A+
356025,26037,97,95,82,274,91.33333333333333,A+
356374,974280,92,96,98,286,95.33333333333333,A+
356596,511203,89,95,90,274,91.33333333333333,A+
356710,322058,93,86,93,272,90.66666666666667,A+
356790,776378,97,92,90,279,93.0,A+
356800,429721,91,91,98,280,93.33333333333333,A+
356802,298947,86,90,95,271,90.33333333333333,A+
356846,257352,99,99,96,294,98.0,A+
357471,717335,89,87,97,273,91.0,A+
357573,937026,92,91,92,275,91.66666666666667,A+
357575,862777,87,98,98,283,94.33333333333333,A+
358381,780909,80,97,95,272,90.66666666666667,A+
358472,180828,93,100,93,286,95.33333333333333,A+
359050,18413,79,94,98,271,90.33333333333333,A+
359138,471724,99,92,84,275,91.66666666666667,A+
359200,1021511,98,91,84,273,91.0,A+
359330,546120,98,97,76,271,90.33333333333333,A+
359364,346197,96,100,100,296,98.66666666666667,A+
359755,2614,98,96,95,289,96.33333333333333,A+
359782,753609,96,85,90,271,90.33333333333333,A+
359846,469566,100,97,77,274,91.33333333333333,A+
359906,578844,100,75,97,272,90.66666666666667,A+
359932,656982,100,85,86,271,90.33333333333333,A+
360025,663054,99,83,100,282,94.0,A+
360036,15111,90,100,86,276,92.0,A+
360477,232529,99,96,89,284,94.66666666666667,A+
360755,939368,100,88,86,274,91.33333333333333,A+
360923,862422,93,88,96,277,92.33333333333333,A+
361018,31276,97,97,80,274,91.33333333333333,A+
361082,355808,98,76,99,273,91.0,A+
361139,724928,100,96,89,285,95.0,A+
361375,196779,92,98,86,276,92.0,A+
361377,380643,93,93,88,274,91.33333333333333,A+
361929,696565,90,87,93,270,90.0,A+
362251,794609,99,100,72,271,90.33333333333333,A+
362351,130160,99,82,92,273,91.0,A+
362536,858833,95,93,94,282,94.0,A+
362542,610332,91,80,99,270,90.0,A+
362803,352744,85,93,93,271,90.33333333333333,A+
363142,974867,82,96,99,277,92.33333333333333,A+
363248,1038520,99,98,76,273,91.0,A+
363261,1007486,100,98,100,298,99.33333333333333,A+
363311,362380,93,89,91,273,91.0,A+
363339,197654,100,95,93,288,96.0,A+
363511,52805,87,94,95,276,92.0,A+
363669,621056,92,86,93,271,90.33333333333333,A+
363765,586438,96,95,95,286,95.33333333333333,A+
363922,955387,98,85,88,271,90.33333333333333,A+
364055,743350,98,89,96,283,94.33333333333333,A+
364068,981042,89,88,93,270,90.0,A+
364435,671326,98,82,96,276,92.0,A+
364471,1023712,90,97,88,275,91.66666666666667,A+
364677,462719,99,93,95,287,95.66666666666667,A+
364864,32114,97,97,76,270,90.0,A+
365094,839525,95,90,98,283,94.33333333333333,A+
365169,218240,97,87,88,272,90.66666666666667,A+
365186,951902,100,90,88,278,92.66666666666667,A+
365300,183684,91,95,100,286,95.33333333333333,A+
365351,687247,91,90,98,279,93.0,A+
365455,691778,89,84,97,270,90.0,A+
365552,449928,97,81,96,274,91.33333333333333,A+
365939,530188,95,86,98,279,93.0,A+
366132,312392,94,89,98,281,93.66666666666667,A+
366553,591910,78,99,97,274,91.33333333333333,A+
366720,255285,97,93,91,281,93.66666666666667,A+
366755,689319,93,100,82,275,91.66666666666667,A+
366836,364900,94,94,99,287,95.66666666666667,A+
366939,134287,85,99,87,271,90.33333333333333,A+
367014,1023229,99,97,89,285,95.0,A+
367025,493620,100,98,96,294,98.0,A+
367244,276147,94,82,97,273,91.0,A+
367297,131701,92,91,90,273,91.0,A+
367542,650458,93,94,92,279,93.0,A+
367745,740176,91,96,86,273,91.0,A+
367785,412931,99,86,86,271,90.33333333333333,A+
367830,766436,99,98,83,280,93.33333333333333,A+
368019,894014,100,82,94,276,92.0,A+
368049,158836,94,100,99,293,97.66666666666667,A+
368543,725099,92,99,82,273,91.0,A+
368548,358443,94,95,90,279,93.0,A+
368669,495184,91,99,88,278,92.66666666666667,A+
368690,557853,98,100,77,275,91.66666666666667,A+
368724,815441,88,98,88,274,91.33333333333333,A+
369040,590730,87,99,98,284,94.66666666666667,A+
369181,1003120,100,96,91,287,95.66666666666667,A+
369491,217403,97,87,92,276,92.0,A+
369569,422115,92,94,88,274,91.33333333333333,A+
369708,72149,87,99,85,271,90.33333333333333,A+
369836,228989,88,90,99,277,92.33333333333333,A+
369868,694823,75,100,99,274,91.33333333333333,A+
369878,827492,97,99,91,287,95.66666666666667,A+
370220,724085,91,97,96,284,94.66666666666667,A+
370271,93751,100,83,100,283,94.33333333333333,A+
370435,883229,77,99,99,275,91.66666666666667,A+
370478,452172,83,100,95,278,92.66666666666667,A+
370583,724750,92,99,82,273,91.0,A+
371051,850279,87,97,89,273,91.0,A+
371080,562624,80,100,99,279,93.0,A+
371138,982338,98,86,88,272,90.66666666666667,A+
371375,378692,94,97,84,275,91.66666666666667,A+
371639,226977,99,95,85,279,93.0,A+
371742,197183,89,86,95,270,90.0,A+
371772,63498,97,99,93,289,96.33333333333333,A+
371926,888548,95,99,99,293,97.66666666666667,A+
372244,92382,83,87,100,270,90.0,A+
372414,736833,100,97,100,297,99.0,A+
372497,114282,85,97,91,273,91.0,A+
372577,509535,98,96,95,289,96.33333333333333,A+
372622,562874,89,100,94,283,94.33333333333333,A+
373024,359207,94,92,98,284,94.66666666666667,A+
373338,917125,92,89,98,279,93.0,A+
373348,341831,96,98,91,285,95.0,A+
373530,252834,80,97,97,274,91.33333333333333,A+
373605,188397,83,100,91,274,91.33333333333333,A+
373848,906688,100,84,92,276,92.0,A+
374317,479569,89,90,95,274,91.33333333333333,A+
374717,1041994,87,89,99,275,91.66666666666667,A+
374782,350341,86,98,87,271,90.33333333333333,A+
375010,713996,99,92,91,282,94.0,A+
375104,162290,93,98,84,275,91.66666666666667,A+
376019,273682,89,98,86,273,91.0,A+
376175,455376,97,83,98,278,92.66666666666667,A+
376219,187315,99,90,93,282,94.0,A+
376229,725265,82,97,95,274,91.33333333333333,A+
376498,906725,85,96,91,272,90.66666666666667,A+
376811,752528,96,86,96,278,92.66666666666667,A+
376814,571048,97,99,85,281,93.66666666666667,A+
376916,580433,96,95,88,279,93.0,A+
377052,857372,96,97,86,279,93.0,A+
377063,752075,81,97,99,277,92.33333333333333,A+
377373,217201,91,98,90,279,93.0,A+
377574,366018,94,95,86,275,91.66666666666667,A+
377603,169438,83,97,95,275,91.66666666666667,A+
377740,744579,91,99,88,278,92.66666666666667,A+
377761,463587,90,94,88,272,90.66666666666667,A+
377858,160407,94,100,89,283,94.33333333333333,A+
377884,12384,97,92,92,281,93.66666666666667,A+
377982,150061,99,85,86,270,90.0,A+
378122,937332,97,79,95,271,90.33333333333333,A+
378226,775265,98,95,83,276,92.0,A+
378547,293376,97,97,93,287,95.66666666666667,A+
378616,281491,94,84,98,276,92.0,A+
378721,835550,88,99,86,273,91.0,A+
378739,279852,95,86,100,281,93.66666666666667,A+
378849,442983,82,93,97,272,90.66666666666667,A+
378948,441277,83,96,91,270,90.0,A+
379050,327463,100,77,100,277,92.33333333333333,A+
379066,1008243,98,89,88,275,91.66666666666667,A+
379162,475522,81,96,95,272,90.66666666666667,A+
379485,791284,97,92,84,273,91.0,A+
379498,820755,97,98,91,286,95.33333333333333,A+
379523,833429,98,100,89,287,95.66666666666667,A+
379580,921106,84,94,95,273,91.0,A+
379828,516479,90,99,82,271,90.33333333333333,A+
379863,711410,91,95,98,284,94.66666666666667,A+
380130,849228,78,99,93,270,90.0,A+
380169,772649,99,97,93,289,96.33333333333333,A+
380230,710927,100,95,100,295,98.33333333333333,A+
380411,542857,86,88,99,273,91.0,A+
380543,873801,100,81,94,275,91.66666666666667,A+
380620,4423,89,96,85,270,90.0,A+
380796,654158,85,98,98,281,93.66666666666667,A+
380809,1014737,97,89,90,276,92.0,A+
381021,275285,88,95,89,272,90.66666666666667,A+
381066,985548,90,90,98,278,92.66666666666667,A+
381293,646661,95,100,87,282,94.0,A+
381484,190005,92,97,92,281,93.66666666666667,A+
381683,747300,99,93,97,289,96.33333333333333,A+
381915,404727,99,86,98,283,94.33333333333333,A+
382071,816652,94,84,95,273,91.0,A+
382161,775301,99,97,76,272,90.66666666666667,A+
382425,759302,81,98,95,274,91.33333333333333,A+
382476,894155,84,93,95,272,90.66666666666667,A+
382605,843095,96,98,85,279,93.0,A+
382668,203719,82,98,93,273,91.0,A+
383095,274509,94,83,100,277,92.33333333333333,A+
383396,426059,84,98,91,273,91.0,A+
383448,1047416,97,93,84,274,91.33333333333333,A+
383710,951163,91,90,98,279,93.0,A+
383765,44520,100,75,95,270,90.0,A+
384097,47663,92,81,97,270,90.0,A+
384156,578184,85,88,97,270,90.0,A+
384299,70340,96,98,95,289,96.33333333333333,A+
384329,336621,87,97,89,273,91.0,A+
384556,497141,99,95,89,283,94.33333333333333,A+
385181,1034840,88,91,91,270,90.0,A+
385192,921209,99,83,92,274,91.33333333333333,A+
385229,738043,82,98,95,275,91.66666666666667,A+
385269,970757,100,94,83,277,92.33333333333333,A+
385344,292465,89,100,92,281,93.66666666666667,A+
385724,707986,91,92,87,270,90.0,A+
385756,723388,92,98,97,287,95.66666666666667,A+
385951,210603,91,99,86,276,92.0,A+
385953,505059,89,95,87,271,90.33333333333333,A+
386341,786057,99,99,85,283,94.33333333333333,A+
386368,593841,96,97,80,273,91.0,A+
386448,753866,99,95,87,281,93.66666666666667,A+
387249,705571,97,82,100,279,93.0,A+
387317,245894,90,97,90,277,92.33333333333333,A+
387425,543743,89,99,88,276,92.0,A+
387912,392780,90,84,97,271,90.33333333333333,A+
388058,850494,96,96,91,283,94.33333333333333,A+
388085,604854,99,77,100,276,92.0,A+
388222,197293,97,85,94,276,92.0,A+
388371,351350,85,95,93,273,91.0,A+
388569,532358,88,95,87,270,90.0,A+
388676,221597,98,91,90,279,93.0,A+
388728,177643,91,93,100,284,94.66666666666667,A+
388834,233709,90,95,88,273,91.0,A+
389022,757143,98,92,82,272,90.66666666666667,A+
389067,958493,90,90,95,275,91.66666666666667,A+
389145,231018,97,88,88,273,91.0,A+
389338,590926,100,78,98,276,92.0,A+
389791,220955,95,81,99,275,91.66666666666667,A+
389955,648257,100,87,88,275,91.66666666666667,A+
390027,249978,97,92,84,273,91.0,A+
390139,483305,96,85,90,271,90.33333333333333,A+
390185,25340,97,96,82,275,91.66666666666667,A+
390501,751629,91,98,94,283,94.33333333333333,A+
390710,1010402,96,84,96,276,92.0,A+
391046,363940,98,74,99,271,90.33333333333333,A+
391052,188611,92,99,93,284,94.66666666666667,A+
391914,650875,92,92,100,284,94.66666666666667,A+
391954,800499,89,97,100,286,95.33333333333333,A+
391968,966215,99,90,84,273,91.0,A+
391982,861836,87,98,100,285,95.0,A+
392014,885638,100,83,96,279,93.0,A+
392159,863823,86,96,98,280,93.33333333333333,A+
392254,295865,100,72,99,271,90.33333333333333,A+
392695,477797,98,91,99,288,96.0,A+
392784,542214,98,100,89,287,95.66666666666667,A+
392842,1022764,97,88,88,273,91.0,A+
392973,740831,81,94,95,270,90.0,A+
392978,977459,100,93,89,282,94.0,A+
393119,738923,91,99,82,272,90.66666666666667,A+
393254,63174,94,90,88,272,90.66666666666667,A+
393379,722727,92,100,91,283,94.33333333333333,A+
393548,691087,98,84,94,276,92.0,A+
393933,294172,88,96,98,282,94.0,A+
394067,452410,90,89,91,270,90.0,A+
394135,10959,98,97,78,273,91.0,A+
394145,546531,88,95,87,270,90.0,A+
394658,337256,96,97,78,271,90.33333333333333,A+
395211,759198,97,88,88,273,91.0,A+
395407,773138,99,97,89,285,95.0,A+
395470,436990,100,92,85,277,92.33333333333333,A+
395711,466589,83,99,93,275,91.66666666666667,A+
395782,793387,99,99,83,281,93.66666666666667,A+
395886,62129,95,92,88,275,91.66666666666667,A+
396078,615308,95,96,84,275,91.66666666666667,A+
396287,435169,91,92,100,283,94.33333333333333,A+
396344,605239,99,78,93,270,90.0,A+
396381,554772,96,92,86,274,91.33333333333333,A+
396658,863969,95,96,91,282,94.0,A+
397422,1042832,72,99,100,271,90.33333333333333,A+
397648,920054,91,86,93,270,90.0,A+
397665,300671,97,96,97,290,96.66666666666667,A+
397792,1024483,98,94,93,285,95.0,A+
397805,1006605,98,91,90,279,93.0,A+
397846,842600,87,98,92,277,92.33333333333333,A+
397904,1020998,100,99,94,293,97.66666666666667,A+
398141,933890,93,96,92,281,93.66666666666667,A+
398190,378112,97,74,99,270,90.0,A+
398334,1042245,81,99,99,279,93.0,A+
398445,192054,97,83,96,276,92.0,A+
398864,1029362,96,88,92,276,92.0,A+
398889,754459,99,95,85,279,93.0,A+
398974,43726,94,87,96,277,92.33333333333333,A+
399336,131518,98,79,98,275,91.66666666666667,A+
399460,647462,94,99,89,282,94.0,A+
399480,936714,92,93,86,271,90.33333333333333,A+
399587,504331,98,94,91,283,94.33333333333333,A+
399623,93470,77,97,96,270,90.0,A+
400025,382098,98,79,93,270,90.0,A+
400206,982406,97,85,96,278,92.66666666666667,A+
400252,1044237,89,97,94,280,93.33333333333333,A+
400392,994695,97,86,100,283,94.33333333333333,A+
400589,906939,93,94,92,279,93.0,A+
400627,850628,87,97,89,273,91.0,A+
401216,343505,96,98,82,276,92.0,A+
401260,336793,86,95,100,281,93.66666666666667,A+
401677,75776,94,90,98,282,94.0,A+
401708,570853,100,77,94,271,90.33333333333333,A+
401961,522203,90,98,96,284,94.66666666666667,A+
402038,494103,91,99,94,284,94.66666666666667,A+
402115,932985,93,98,88,279,93.0,A+
402134,117957,95,100,97,292,97.33333333333333,A+
402453,723064,74,100,96,270,90.0,A+
402566,395060,93,93,86,272,90.66666666666667,A+
402727,492208,89,91,100,280,93.33333333333333,A+
402761,466797,82,98,97,277,92.33333333333333,A+
403106,921656,90,83,97,270,90.0,A+
403112,205914,97,84,90,271,90.33333333333333,A+
403354,907593,99,82,96,277,92.33333333333333,A+
403355,1021266,98,91,86,275,91.66666666666667,A+
403416,310233,96,94,90,280,93.33333333333333,A+
403577,593040,96,99,78,273,91.0,A+
403861,799184,99,100,85,284,94.66666666666667,A+
404195,820779,80,100,91,271,90.33333333333333,A+
404199,440684,83,97,93,273,91.0,A+
404629,607232,92,86,93,271,90.33333333333333,A+
404810,821929,79,98,93,270,90.0,A+
405155,931591,94,100,89,283,94.33333333333333,A+
405200,266798,80,98,93,271,90.33333333333333,A+
405367,287549,98,99,77,274,91.33333333333333,A+
405792,303911,95,91,98,284,94.66666666666667,A+
405940,656223,94,98,80,272,90.66666666666667,A+
406050,502160,97,89,84,270,90.0,A+
406137,224048,100,98,89,287,95.66666666666667,A+
406222,449310,91,95,86,272,90.66666666666667,A+
406761,727111,97,83,91,271,90.33333333333333,A+
406848,854193,88,100,96,284,94.66666666666667,A+
406999,676498,84,97,91,272,90.66666666666667,A+
407183,85490,96,98,87,281,93.66666666666667,A+
407507,591170,100,78,96,274,91.33333333333333,A+
407866,686300,97,81,98,276,92.0,A+
407959,585006,88,100,84,272,90.66666666666667,A+
407981,280458,97,95,97,289,96.33333333333333,A+
408398,30599,94,86,96,276,92.0,A+
408437,383150,92,88,96,276,92.0,A+
408460,489987,99,97,81,277,92.33333333333333,A+
409345,83449,84,90,99,273,91.0,A+
409490,1014939,88,88,97,273,91.0,A+
409843,488196,82,98,93,273,91.0,A+
410043,882916,93,90,87,270,90.0,A+
410305,496885,80,95,97,272,90.66666666666667,A+
410314,797473,99,100,100,299,99.66666666666667,A+
410321,2406,98,97,91,286,95.33333333333333,A+
410527,224427,91,99,86,276,92.0,A+
410609,537880,97,95,95,287,95.66666666666667,A+
410835,16787,97,95,95,287,95.66666666666667,A+
410889,891305,95,98,84,277,92.33333333333333,A+
410987,136488,93,95,86,274,91.33333333333333,A+
410992,137217,92,91,100,283,94.33333333333333,A+
411011,738245,88,87,97,272,90.66666666666667,A+
411074,957442,82,92,99,273,91.0,A+
411128,917314,95,100,87,282,94.0,A+
411298,797240,94,81,97,272,90.66666666666667,A+
411311,741124,99,95,81,275,91.66666666666667,A+
411399,205566,81,95,95,271,90.33333333333333,A+
411418,994273,73,99,100,272,90.66666666666667,A+
411463,128418,100,85,92,277,92.33333333333333,A+
411465,36750,88,97,100,285,95.0,A+
411928,194365,98,89,99,286,95.33333333333333,A+
411964,963098,97,82,100,279,93.0,A+
412003,426963,99,85,90,274,91.33333333333333,A+
412102,208568,89,90,95,274,91.33333333333333,A+
412145,256888,81,100,99,280,93.33333333333333,A+
412455,529423,96,88,90,274,91.33333333333333,A+
412931,906621,85,96,89,270,90.0,A+
413081,1009858,99,96,91,286,95.33333333333333,A+
413242,518124,99,97,76,272,90.66666666666667,A+
413371,12085,100,71,99,270,90.0,A+
413481,708011,96,79,99,274,91.33333333333333,A+
413506,8123,81,100,91,272,90.66666666666667,A+
413687,586884,86,95,100,281,93.66666666666667,A+
414050,469236,97,84,92,273,91.0,A+
414263,798536,87,90,97,274,91.33333333333333,A+
414318,427312,83,96,95,274,91.33333333333333,A+
414371,237384,99,98,93,290,96.66666666666667,A+
414760,449170,91,94,90,275,91.66666666666667,A+
415000,805628,96,90,94,280,93.33333333333333,A+
415090,952673,93,97,99,289,96.33333333333333,A+
415141,166545,100,91,89,280,93.33333333333333,A+
415885,523639,98,97,87,282,94.0,A+
416114,302242,97,96,87,280,93.33333333333333,A+
416142,298714,89,100,96,285,95.0,A+
416144,584970,88,99,90,277,92.33333333333333,A+
416287,270675,96,89,100,285,95.0,A+
416576,14482,89,100,94,283,94.33333333333333,A+
416590,127366,91,87,95,273,91.0,A+
416910,131658,98,80,94,272,90.66666666666667,A+
416947,812128,89,100,98,287,95.66666666666667,A+
417070,564268,88,98,94,280,93.33333333333333,A+
417227,339966,85,92,93,270,90.0,A+
417658,442224,92,95,86,273,91.0,A+
417675,155962,83,96,95,274,91.33333333333333,A+
417695,752747,91,99,82,272,90.66666666666667,A+
417912,721290,99,91,95,285,95.0,A+
418004,698105,98,86,86,270,90.0,A+
418288,72169,84,86,100,270,90.0,A+
418433,705968,100,93,93,286,95.33333333333333,A+
419490,672824,98,80,98,276,92.0,A+
419606,389497,98,78,99,275,91.66666666666667,A+
419676,672164,83,93,97,273,91.0,A+
419892,994279,98,88,92,278,92.66666666666667,A+
419908,150973,92,93,92,277,92.33333333333333,A+
420015,723492,91,98,99,288,96.0,A+
421607,477100,98,92,99,289,96.33333333333333,A+
421785,745698,99,96,93,288,96.0,A+
422190,780396,98,95,99,292,97.33333333333333,A+
422243,598611,93,87,98,278,92.66666666666667,A+
422256,900544,84,94,95,273,91.0,A+
422376,998877,95,80,99,274,91.33333333333333,A+
423143,1025803,89,95,87,271,90.33333333333333,A+
423472,913084,93,95,94,282,94.0,A+
423695,110650,93,91,94,278,92.66666666666667,A+
423991,669864,99,86,88,273,91.0,A+
424358,209662,92,100,88,280,93.33333333333333,A+
424517,503707,99,97,79,275,91.66666666666667,A+
424782,224134,88,88,95,271,90.33333333333333,A+
424846,966778,92,99,90,281,93.66666666666667,A+
425153,805524,96,90,92,278,92.66666666666667,A+
425204,763043,98,92,86,276,92.0,A+
425302,892620,85,94,99,278,92.66666666666667,A+
425500,879744,94,93,94,281,93.66666666666667,A+
425513,926107,93,97,92,282,94.0,A+
425982,1045253,98,94,97,289,96.33333333333333,A+
426118,921075,92,93,98,283,94.33333333333333,A+
426244,661176,85,100,89,274,91.33333333333333,A+
426290,921069,99,83,96,278,92.66666666666667,A+
426404,445643,83,98,100,281,93.66666666666667,A+
426506,899332,94,97,82,273,91.0,A+
426646,501073,88,89,93,270,90.0,A+
426765,984607,90,91,100,281,93.66666666666667,A+
426787,657679,84,95,91,270,90.0,A+
426910,422359,92,94,86,272,90.66666666666667,A+
427751,443692,100,91,91,282,94.0,A+
428200,279290,86,88,99,273,91.0,A+
428202,465703,95,78,99,272,90.66666666666667,A+
428204,461245,98,87,88,273,91.0,A+
428244,994169,89,89,93,271,90.33333333333333,A+
428341,142346,84,95,99,278,92.66666666666667,A+
428391,204692,97,84,100,281,93.66666666666667,A+
428450,938152,93,98,99,290,96.66666666666667,A+
428513,964742,90,90,100,280,93.33333333333333,A+
428817,518186,89,96,87,272,90.66666666666667,A+
429002,385137,91,86,93,270,90.0,A+
429094,439430,99,89,84,272,90.66666666666667,A+
429363,555048,95,90,98,283,94.33333333333333,A+
429404,756612,88,91,95,274,91.33333333333333,A+
429407,270375,99,100,94,293,97.66666666666667,A+
429476,91275,78,100,95,273,91.0,A+
429884,95738,100,81,98,279,93.0,A+
430006,440091,83,97,95,275,91.66666666666667,A+
430108,568352,96,93,88,277,92.33333333333333,A+
430167,941178,99,84,94,277,92.33333333333333,A+
430223,1013906,91,100,97,288,96.0,A+
430355,539830,96,91,99,286,95.33333333333333,A+
430706,839409,92,81,97,270,90.0,A+
430830,609048,100,81,98,279,93.0,A+
430915,745025,97,88,88,273,91.0,A+
431021,38186,97,95,91,283,94.33333333333333,A+
431165,798738,93,79,99,271,90.33333333333333,A+
431191,620218,92,86,97,275,91.66666666666667,A+
431267,155240,94,100,78,272,90.66666666666667,A+
431909,482729,100,99,71,270,90.0,A+
432059,187205,90,91,93,274,91.33333333333333,A+
432502,957894,97,80,95,272,90.66666666666667,A+
432819,968000,93,99,80,272,90.66666666666667,A+
433151,160993,100,90,84,274,91.33333333333333,A+
433474,831258,96,95,82,273,91.0,A+
433623,654610,85,97,100,282,94.0,A+
433673,941625,89,83,99,271,90.33333333333333,A+
434012,224036,97,88,90,275,91.66666666666667,A+
434282,1015794,100,98,89,287,95.66666666666667,A+
434402,237965,81,98,97,276,92.0,A+
434506,913640,93,94,98,285,95.0,A+
434519,764938,100,100,81,281,93.66666666666667,A+
434662,821745,100,76,95,271,90.33333333333333,A+
434772,722929,83,99,98,280,93.33333333333333,A+
435059,974060,89,88,95,272,90.66666666666667,A+
435103,238251,91,99,86,276,92.0,A+
435169,515111,96,88,94,278,92.66666666666667,A+
435393,1004820,89,92,100,281,93.66666666666667,A+
435475,965622,99,90,86,275,91.66666666666667,A+
435840,732565,90,95,96,281,93.66666666666667,A+
436059,274031,89,98,86,273,91.0,A+
436318,654579,85,100,85,270,90.0,A+
436357,512255,98,93,86,277,92.33333333333333,A+
436431,662326,85,98,91,274,91.33333333333333,A+
436581,101197,95,97,82,274,91.33333333333333,A+
436794,23212,98,97,89,284,94.66666666666667,A+
437145,391330,94,98,88,280,93.33333333333333,A+
437317,513723,90,100,97,287,95.66666666666667,A+
437637,994126,95,78,97,270,90.0,A+
437643,433946,83,96,93,272,90.66666666666667,A+
438074,40124,93,82,95,270,90.0,A+
438113,841310,88,99,94,281,93.66666666666667,A+
438419,522734,99,99,83,281,93.66666666666667,A+
438484,241658,79,92,100,271,90.33333333333333,A+
438560,248615,97,91,99,287,95.66666666666667,A+
438718,984497,96,82,96,274,91.33333333333333,A+
438743,720978,99,92,89,280,93.33333333333333,A+
438943,248603,94,81,99,274,91.33333333333333,A+
439023,121576,85,96,95,276,92.0,A+
439027,705828,100,92,97,289,96.33333333333333,A+
439104,877585,95,98,87,280,93.33333333333333,A+
439204,203371,82,99,93,274,91.33333333333333,A+
439310,453602,98,88,84,270,90.0,A+
439807,13185,96,91,94,281,93.66666666666667,A+
439820,576203,95,90,96,281,93.66666666666667,A+
440062,667829,97,77,97,271,90.33333333333333,A+
440338,355459,99,76,100,275,91.66666666666667,A+
440354,226929,80,94,97,271,90.33333333333333,A+
440413,115157,93,93,98,284,94.66666666666667,A+
441210,389680,76,100,97,273,91.0,A+
442065,724261,92,99,86,277,92.33333333333333,A+
442271,766571,90,99,82,271,90.33333333333333,A+
442399,694963,91,90,89,270,90.0,A+
442910,101919,100,83,94,277,92.33333333333333,A+
442932,771591,97,89,94,280,93.33333333333333,A+
442964,487921,90,97,98,285,95.0,A+
443014,775571,89,94,92,275,91.66666666666667,A+
443243,495112,90,96,100,286,95.33333333333333,A+
443365,548341,87,91,95,273,91.0,A+
443391,609121,85,94,91,270,90.0,A+
443462,319680,100,78,100,278,92.66666666666667,A+
443771,407105,93,94,92,279,93.0,A+
443902,194021,100,93,78,271,90.33333333333333,A+
443991,245467,96,85,100,281,93.66666666666667,A+
443995,77023,99,77,100,276,92.0,A+
444023,358957,100,82,98,280,93.33333333333333,A+
444034,630942,93,92,92,277,92.33333333333333,A+
444082,85094,77,98,99,274,91.33333333333333,A+
444113,660901,94,98,95,287,95.66666666666667,A+
444144,488312,100,97,89,286,95.33333333333333,A+
444224,418385,93,98,90,281,93.66666666666667,A+
444344,97487,93,89,100,282,94.0,A+
444410,997207,97,85,88,270,90.0,A+
444453,580281,93,85,93,271,90.33333333333333,A+
444500,1000913,82,100,95,277,92.33333333333333,A+
444839,611383,99,79,96,274,91.33333333333333,A+
445404,909196,98,79,100,277,92.33333333333333,A+
445465,690218,99,88,84,271,90.33333333333333,A+
445589,593408,93,86,93,272,90.66666666666667,A+
445623,194353,96,79,99,274,91.33333333333333,A+
445763,458977,98,88,99,285,95.0,A+
445892,90101,96,100,93,289,96.33333333333333,A+
446640,677892,99,85,86,270,90.0,A+
446709,196358,91,97,98,286,95.33333333333333,A+
446753,69435,97,100,91,288,96.0,A+
446884,5579,97,94,84,275,91.66666666666667,A+
448154,625018,96,100,93,289,96.33333333333333,A+
448879,983696,97,83,94,274,91.33333333333333,A+
449069,930705,91,89,100,280,93.33333333333333,A+
449463,639392,86,99,100,285,95.0,A+
449559,952214,99,88,95,282,94.0,A+
449731,812825,89,99,98,286,95.33333333333333,A+
449744,398478,84,96,99,279,93.0,A+
449914,850384,87,97,91,275,91.66666666666667,A+
450154,347731,96,99,95,290,96.66666666666667,A+
450323,18071,88,94,96,278,92.66666666666667,A+
450350,363468,86,99,87,272,90.66666666666667,A+
450505,191637,97,85,88,270,90.0,A+
450816,442077,98,84,88,270,90.0,A+
450969,511490,99,96,78,273,91.0,A+
451156,252914,98,94,99,291,97.0,A+
451194,314336,100,76,100,276,92.0,A+
451360,407239,84,95,91,270,90.0,A+
451557,368629,92,89,96,277,92.33333333333333,A+
451704,195275,99,91,82,272,90.66666666666667,A+
451909,68683,100,80,96,276,92.0,A+
451920,267318,95,84,98,277,92.33333333333333,A+
451998,1007479,98,92,80,270,90.0,A+
452137,49180,88,99,100,287,95.66666666666667,A+
452164,243485,97,91,82,270,90.0,A+
452282,409300,92,91,94,277,92.33333333333333,A+
452503,475919,100,96,83,279,93.0,A+
452622,987682,98,88,88,274,91.33333333333333,A+
452692,765905,90,97,96,283,94.33333333333333,A+
452817,424390,93,98,97,288,96.0,A+
453383,476990,90,92,100,282,94.0,A+
453484,560985,96,92,96,284,94.66666666666667,A+
453634,41751,97,99,97,293,97.66666666666667,A+
453971,926938,100,86,86,272,90.66666666666667,A+
454024,449280,100,93,89,282,94.0,A+
454750,356211,95,97,95,287,95.66666666666667,A+
454863,598966,87,97,100,284,94.66666666666667,A+
454919,693917,91,92,89,272,90.66666666666667,A+
455034,377360,85,97,96,278,92.66666666666667,A+
455039,516345,99,98,83,280,93.33333333333333,A+
455063,205999,100,96,77,273,91.0,A+
456076,364067,95,98,82,275,91.66666666666667,A+
456125,174635,90,88,97,275,91.66666666666667,A+
456681,225655,100,99,73,272,90.66666666666667,A+
456838,1025907,89,94,89,272,90.66666666666667,A+
457108,627445,76,97,98,271,90.33333333333333,A+
457401,1008244,82,100,93,275,91.66666666666667,A+
457579,669064,84,98,91,273,91.0,A+
457608,126816,85,98,94,277,92.33333333333333,A+
457736,291720,86,90,99,275,91.66666666666667,A+
457971,809156,88,96,90,274,91.33333333333333,A+
458010,1037249,80,97,99,276,92.0,A+
458613,875758,93,88,100,281,93.66666666666667,A+
458640,572650,96,96,89,281,93.66666666666667,A+
458881,308625,88,97,90,275,91.66666666666667,A+
458956,451303,100,92,80,272,90.66666666666667,A+
459085,35588,86,89,99,274,91.33333333333333,A+
459352,501281,88,88,97,273,91.0,A+
459509,941605,93,96,84,273,91.0,A+
459679,252075,90,99,86,275,91.66666666666667,A+
459749,188917,98,87,96,281,93.66666666666667,A+
459787,280898,94,84,100,278,92.66666666666667,A+
460052,305422,97,99,100,296,98.66666666666667,A+
460216,231471,97,87,90,274,91.33333333333333,A+
460294,312300,97,100,95,292,97.33333333333333,A+
460708,737450,82,99,97,278,92.66666666666667,A+
460726,323739,87,96,87,270,90.0,A+
460884,530897,97,95,97,289,96.33333333333333,A+
461000,154500,100,89,82,271,90.33333333333333,A+
461034,1033690,89,93,89,271,90.33333333333333,A+
461241,819300,92,79,99,270,90.0,A+
461254,953015,99,87,96,282,94.0,A+
461291,441136,98,85,90,273,91.0,A+
461723,410003,100,90,91,281,93.66666666666667,A+
461763,687241,97,80,95,272,90.66666666666667,A+
461852,294624,88,95,100,283,94.33333333333333,A+
462144,613425,95,98,89,282,94.0,A+
462526,916545,94,99,99,292,97.33333333333333,A+
462690,656212,99,84,98,281,93.66666666666667,A+
462693,232877,99,95,89,283,94.33333333333333,A+
462696,954133,99,87,84,270,90.0,A+
462763,143532,83,94,95,272,90.66666666666667,A+
462850,647254,95,100,85,280,93.33333333333333,A+
462969,709392,93,100,86,279,93.0,A+
463124,889037,95,99,95,289,96.33333333333333,A+
463201,632447,86,100,96,282,94.0,A+
463206,252938,96,86,94,276,92.0,A+
463257,647426,94,98,95,287,95.66666666666667,A+
463258,1016681,87,86,97,270,90.0,A+
463278,701524,90,89,100,279,93.0,A+
463536,848036,85,90,95,270,90.0,A+
463839,609231,94,93,90,277,92.33333333333333,A+
464013,252216,90,100,82,272,90.66666666666667,A+
464189,614434,95,95,95,285,95.0,A+
464433,147580,75,98,100,273,91.0,A+
464481,577487,100,78,92,270,90.0,A+
464610,557420,79,99,95,273,91.0,A+
464691,298952,95,90,92,277,92.33333333333333,A+
464832,915065,84,93,95,272,90.66666666666667,A+
464874,344075,98,73,99,270,90.0,A+
465005,822901,93,84,100,277,92.33333333333333,A+
465472,519745,94,81,95,270,90.0,A+
465762,232725,96,85,94,275,91.66666666666667,A+
466154,671259,83,95,93,271,90.33333333333333,A+
466238,791945,96,90,90,276,92.0,A+
466278,684489,99,85,90,274,91.33333333333333,A+
466691,697757,83,97,91,271,90.33333333333333,A+
466847,780395,90,99,82,271,90.33333333333333,A+
466868,829375,97,97,87,281,93.66666666666667,A+
466988,404629,93,97,99,289,96.33333333333333,A+
467004,528458,98,98,98,294,98.0,A+
467187,446724,83,98,93,274,91.33333333333333,A+
467276,787855,95,85,94,274,91.33333333333333,A+
467468,235659,89,92,91,272,90.66666666666667,A+
467477,461912,91,95,96,282,94.0,A+
467490,748688,89,91,100,280,93.33333333333333,A+
467528,939899,94,100,78,272,90.66666666666667,A+
467782,120048,94,97,97,288,96.0,A+
468296,225388,87,85,99,271,90.33333333333333,A+
468303,759614,96,85,96,277,92.33333333333333,A+
468349,560422,87,93,95,275,91.66666666666667,A+
468457,501335,100,99,87,286,95.33333333333333,A+
468662,668874,97,76,97,270,90.0,A+
468733,694590,93,100,95,288,96.0,A+
469200,926798,84,96,95,275,91.66666666666667,A+
469394,930491,82,90,99,271,90.33333333333333,A+
470197,745282,100,98,85,283,94.33333333333333,A+
470322,428461,98,83,92,273,91.0,A+
470734,850910,95,94,99,288,96.0,A+
470814,63920,97,100,81,278,92.66666666666667,A+
470961,821139,98,99,85,282,94.0,A+
471299,18878,96,92,95,283,94.33333333333333,A+
471302,510428,95,84,100,279,93.0,A+
471328,193320,99,90,99,288,96.0,A+
471658,785043,99,98,100,297,99.0,A+
471682,55391,95,91,88,274,91.33333333333333,A+
471875,841793,94,89,88,271,90.33333333333333,A+
472045,783917,97,91,92,280,93.33333333333333,A+
472167,818627,98,100,98,296,98.66666666666667,A+
472232,489658,96,84,96,276,92.0,A+
473122,777840,96,89,98,283,94.33333333333333,A+
473133,987505,98,87,98,283,94.33333333333333,A+
473391,446828,98,87,90,275,91.66666666666667,A+
473435,120463,85,99,87,271,90.33333333333333,A+
473818,547950,93,80,99,272,90.66666666666667,A+
474446,712486,97,84,90,271,90.33333333333333,A+
474551,308417,88,98,85,271,90.33333333333333,A+
474587,300695,94,87,92,273,91.0,A+
474624,227821,100,100,100,300,100.0,A+
474906,656738,84,95,93,272,90.66666666666667,A+
474987,899015,94,95,97,286,95.33333333333333,A+
475191,661800,100,86,96,282,94.0,A+
475236,611750,96,98,97,291,97.0,A+
475366,870945,86,97,91,274,91.33333333333333,A+
475484,477124,81,93,99,273,91.0,A+
475751,61860,97,100,95,292,97.33333333333333,A+
476317,188569,98,88,96,282,94.0,A+
476336,287812,95,86,89,270,90.0,A+
476558,799386,89,100,92,281,93.66666666666667,A+
476984,84647,87,99,94,280,93.33333333333333,A+
477141,973619,92,98,92,282,94.0,A+
477169,92504,95,96,99,290,96.66666666666667,A+
477354,603943,91,80,99,270,90.0,A+
477755,742189,95,81,95,271,90.33333333333333,A+
477886,315649,97,98,78,273,91.0,A+
477891,994041,91,98,97,286,95.33333333333333,A+
477927,39788,96,92,94,282,94.0,A+
477949,97151,95,99,99,293,97.66666666666667,A+
478328,408395,92,93,90,275,91.66666666666667,A+
478687,724079,82,97,99,278,92.66666666666667,A+
478784,46722,93,82,99,274,91.33333333333333,A+
479147,5292,88,93,95,276,92.0,A+
479442,449439,97,81,100,278,92.66666666666667,A+
479464,627598,95,97,88,280,93.33333333333333,A+
479838,113939,94,97,88,279,93.0,A+
479954,234816,95,82,93,270,90.0,A+
479978,603643,94,91,92,277,92.33333333333333,A+
479988,432516,83,97,99,279,93.0,A+
480062,1014633,98,90,88,276,92.0,A+
480103,955699,98,83,94,275,91.66666666666667,A+
480216,797080,97,93,86,276,92.0,A+
480597,539916,100,71,99,270,90.0,A+
481175,860686,87,100,98,285,95.0,A+
481234,50512,97,98,89,284,94.66666666666667,A+
481524,613731,86,96,98,280,93.33333333333333,A+
481637,292429,89,99,98,286,95.33333333333333,A+
481718,355643,77,99,97,273,91.0,A+
482285,432301,74,99,98,271,90.33333333333333,A+
482318,666722,92,91,92,275,91.66666666666667,A+
483038,162491,99,87,86,272,90.66666666666667,A+
483454,924909,91,88,97,276,92.0,A+
483533,350972,94,94,97,285,95.0,A+
483603,459190,99,91,82,272,90.66666666666667,A+
484048,621166,85,96,97,278,92.66666666666667,A+
484128,351943,85,95,91,271,90.33333333333333,A+
484255,265899,90,99,86,275,91.66666666666667,A+
484480,949493,92,95,86,273,91.0,A+
484515,222056,91,100,95,286,95.33333333333333,A+
484681,1045357,97,93,99,289,96.33333333333333,A+
484916,148808,100,88,82,270,90.0,A+
484933,202331,92,100,90,282,94.0,A+
485781,771536,100,100,85,285,95.0,A+
485823,976029,100,94,95,289,96.33333333333333,A+
485845,723284,92,99,95,286,95.33333333333333,A+
485937,227772,89,93,89,271,90.33333333333333,A+
486038,797136,78,92,100,270,90.0,A+
486179,414607,92,92,100,284,94.66666666666667,A+
486549,579584,93,86,93,272,90.66666666666667,A+
486627,1013067,99,94,78,271,90.33333333333333,A+
486630,956897,100,92,89,281,93.66666666666667,A+
486723,555745,95,89,98,282,94.0,A+
487087,857476,96,96,89,281,93.66666666666667,A+
487232,493265,91,99,99,289,96.33333333333333,A+
487334,266462,98,97,87,282,94.0,A+
487384,426585,92,95,98,285,95.0,A+
487385,60839,95,93,90,278,92.66666666666667,A+
487596,784957,87,90,95,272,90.66666666666667,A+
487872,208537,98,88,99,285,95.0,A+
487981,924945,91,89,91,271,90.33333333333333,A+
488095,276251,93,81,99,273,91.0,A+
488168,507438,90,99,99,288,96.0,A+
488470,406793,93,96,86,275,91.66666666666667,A+
488542,726707,100,95,83,278,92.66666666666667,A+
488561,9376,95,87,90,272,90.66666666666667,A+
489045,521500,96,89,94,279,93.0,A+
489275,1022844,99,96,95,290,96.66666666666667,A+
489470,984197,100,93,89,282,94.0,A+
489500,64672,78,98,95,271,90.33333333333333,A+
489516,385045,94,96,90,280,93.33333333333333,A+
489541,850811,96,98,76,270,90.0,A+
489789,99939,94,95,99,288,96.0,A+
489869,457607,96,81,93,270,90.0,A+
489879,336175,96,98,84,278,92.66666666666667,A+
489892,25163,97,94,93,284,94.66666666666667,A+
489969,962167,92,97,84,273,91.0,A+
490052,971100,91,94,85,270,90.0,A+
490102,612758,87,100,86,273,91.0,A+
490241,501177,88,89,95,272,90.66666666666667,A+
490431,147133,84,99,96,279,93.0,A+
490475,301392,94,86,91,271,90.33333333333333,A+
490544,363676,86,98,91,275,91.66666666666667,A+
490581,915836,92,90,100,282,94.0,A+
490906,164650,98,82,94,274,91.33333333333333,A+
491092,811185,97,95,78,270,90.0,A+
491423,794219,89,99,82,270,90.0,A+
491466,863920,92,85,97,274,91.33333333333333,A+
491543,949206,83,94,97,274,91.33333333333333,A+
491899,783361,97,93,88,278,92.66666666666667,A+
491921,921105,99,84,90,273,91.0,A+
491938,105001,86,100,90,276,92.0,A+
491959,676608,93,97,90,280,93.33333333333333,A+
492075,684692,89,84,97,270,90.0,A+
492237,955675,100,92,99,291,97.0,A+
492281,412088,75,98,98,271,90.33333333333333,A+
492749,85308,86,97,100,283,94.33333333333333,A+
492788,741155,99,92,95,286,95.33333333333333,A+
492829,617632,99,79,100,278,92.66666666666667,A+
493223,368776,86,100,94,280,93.33333333333333,A+
493382,780847,90,98,84,272,90.66666666666667,A+
494049,247943,80,94,99,273,91.0,A+
494392,192487,100,94,83,277,92.33333333333333,A+
494889,1041291,94,80,97,271,90.33333333333333,A+
494964,161612,90,87,99,276,92.0,A+
495025,64372,97,99,83,279,93.0,A+
495377,900201,94,94,92,280,93.33333333333333,A+
495531,915627,92,91,96,279,93.0,A+
495653,931640,82,88,100,270,90.0,A+
496037,833105,95,92,84,271,90.33333333333333,A+
496475,14127,80,100,97,277,92.33333333333333,A+
496946,392749,99,83,100,282,94.0,A+
497324,703517,98,86,94,278,92.66666666666667,A+
497391,420648,92,93,100,285,95.0,A+
497645,822381,79,97,95,271,90.33333333333333,A+
497786,689088,96,77,97,270,90.0,A+
497924,448057,92,97,82,271,90.33333333333333,A+
498102,713018,99,92,99,290,96.66666666666667,A+
498133,601172,96,97,78,271,90.33333333333333,A+
498801,429856,82,92,97,271,90.33333333333333,A+
498934,68127,85,92,97,274,91.33333333333333,A+
499434,1035194,97,90,88,275,91.66666666666667,A+
499859,520430,99,99,100,298,99.33333333333333,A+
500451,192940,100,93,85,278,92.66666666666667,A+
500594,1003713,99,95,89,283,94.33333333333333,A+
500705,846886,86,92,93,271,90.33333333333333,A+
500863,191913,97,82,100,279,93.0,A+
501147,828978,78,97,99,274,91.33333333333333,A+
501215,441839,91,94,92,277,92.33333333333333,A+
501250,952886,93,100,82,275,91.66666666666667,A+
501298,778237,99,99,91,289,96.33333333333333,A+
501368,171883,91,93,92,276,92.0,A+
501443,584377,88,100,92,280,93.33333333333333,A+
501628,689870,84,99,89,272,90.66666666666667,A+
502086,317392,96,96,78,270,90.0,A+
502212,510132,99,99,73,271,90.33333333333333,A+
502284,379659,84,93,99,276,92.0,A+
502450,54694,95,92,88,275,91.66666666666667,A+
502705,273236,98,99,81,278,92.66666666666667,A+
502731,286174,95,88,92,275,91.66666666666667,A+
503376,503046,100,99,73,272,90.66666666666667,A+
503427,277461,99,100,94,293,97.66666666666667,A+
503429,134495,85,98,91,274,91.33333333333333,A+
503502,189406,83,98,97,278,92.66666666666667,A+
503899,855678,100,77,93,270,90.0,A+
504448,461141,82,98,91,271,90.33333333333333,A+
504593,828073,79,99,95,273,91.0,A+
504668,730468,98,88,94,280,93.33333333333333,A+
504727,146895,94,98,95,287,95.66666666666667,A+
504952,621515,85,95,97,277,92.33333333333333,A+
505224,842111,87,98,96,281,93.66666666666667,A+
505261,36682,88,98,92,278,92.66666666666667,A+
505374,57440,85,88,97,270,90.0,A+
505432,249441,79,91,100,270,90.0,A+
505551,981782,83,98,89,270,90.0,A+
505755,730707,73,99,100,272,90.66666666666667,A+
506176,989681,100,96,85,281,93.66666666666667,A+
506628,286425,89,99,92,280,93.33333333333333,A+
506637,965023,90,91,91,272,90.66666666666667,A+
506733,222374,100,98,98,296,98.66666666666667,A+
506896,300242,95,88,90,273,91.0,A+
506994,616721,91,81,99,271,90.33333333333333,A+
507230,104707,99,79,93,271,90.33333333333333,A+
507482,217158,97,87,94,278,92.66666666666667,A+
507946,765759,96,86,98,280,93.33333333333333,A+
508115,586578,96,96,91,283,94.33333333333333,A+
508237,890627,92,87,100,279,93.0,A+
508296,294208,88,97,92,277,92.33333333333333,A+
508322,904744,94,98,91,283,94.33333333333333,A+
508452,480370,88,88,97,273,91.0,A+
508681,148361,94,99,82,275,91.66666666666667,A+
508791,777852,99,99,98,296,98.66666666666667,A+
508831,279723,89,99,86,274,91.33333333333333,A+
509150,935835,83,93,99,275,91.66666666666667,A+
509324,237347,99,97,100,296,98.66666666666667,A+
509366,303355,96,93,94,283,94.33333333333333,A+
509533,160437,100,91,80,271,90.33333333333333,A+
509597,256185,88,91,97,276,92.0,A+
509674,310331,87,94,95,276,92.0,A+
509849,933474,93,98,84,275,91.66666666666667,A+
510147,18394,97,96,78,271,90.33333333333333,A+
510545,532830,100,71,99,270,90.0,A+
510631,847559,88,99,98,285,95.0,A+
510690,70573,78,99,99,276,92.0,A+
511506,661091,97,77,97,271,90.33333333333333,A+
511803,300285,89,100,86,275,91.66666666666667,A+
511915,777388,97,90,96,283,94.33333333333333,A+
512012,629995,84,93,97,274,91.33333333333333,A+
512043,630900,99,80,96,275,91.66666666666667,A+
512044,365461,94,96,82,272,90.66666666666667,A+
512370,241186,99,95,78,272,90.66666666666667,A+
512477,271213,99,100,89,288,96.0,A+
512570,15148,98,97,97,292,97.33333333333333,A+
512719,957142,100,93,87,280,93.33333333333333,A+
512923,789010,88,94,98,280,93.33333333333333,A+
512955,729349,90,91,89,270,90.0,A+
513006,1008360,100,98,89,287,95.66666666666667,A+
513366,568909,95,91,92,278,92.66666666666667,A+
513692,258728,87,87,99,273,91.0,A+
513955,768791,95,82,95,272,90.66666666666667,A+
513975,22369,89,98,96,283,94.33333333333333,A+
513983,316029,96,95,93,284,94.66666666666667,A+
514161,405216,99,86,94,279,93.0,A+
514375,154562,90,88,93,271,90.33333333333333,A+
514551,482853,81,96,93,270,90.0,A+
514591,325971,94,89,100,283,94.33333333333333,A+
514680,802730,88,94,96,278,92.66666666666667,A+
515315,767684,89,96,90,275,91.66666666666667,A+
515606,142633,93,96,88,277,92.33333333333333,A+
515999,808043,89,99,82,270,90.0,A+
516212,8764,99,100,77,276,92.0,A+
516344,293811,85,87,99,271,90.33333333333333,A+
516416,71282,96,97,93,286,95.33333333333333,A+
516603,692169,98,84,88,270,90.0,A+
516616,445288,90,89,97,276,92.0,A+
516789,24226,98,99,74,271,90.33333333333333,A+
516896,296647,87,94,91,272,90.66666666666667,A+
516939,523670,90,98,84,272,90.66666666666667,A+
516996,119553,100,86,99,285,95.0,A+
517450,401449,93,94,86,273,91.0,A+
518010,503280,90,96,94,280,93.33333333333333,A+
518082,286627,95,87,94,276,92.0,A+
518254,553232,87,94,93,274,91.33333333333333,A+
518563,421687,98,82,98,278,92.66666666666667,A+
518945,778970,99,100,85,284,94.66666666666667,A+
518987,653846,85,100,92,277,92.33333333333333,A+
519166,773829,89,97,92,278,92.66666666666667,A+
519716,939570,90,87,93,270,90.0,A+
519834,605434,96,100,85,281,93.66666666666667,A+
520214,91593,86,98,98,282,94.0,A+
520585,1027057,89,92,91,272,90.66666666666667,A+
520590,57947,96,97,89,282,94.0,A+
520966,309628,93,84,93,270,90.0,A+
521104,348458,87,99,92,278,92.66666666666667,A+
521342,811309,78,92,100,270,90.0,A+
521862,205780,90,94,96,280,93.33333333333333,A+
521958,955393,92,95,90,277,92.33333333333333,A+
522088,284566,87,92,91,270,90.0,A+
522091,796487,97,94,88,279,93.0,A+
522092,151321,92,93,92,277,92.33333333333333,A+
522101,883822,92,88,91,271,90.33333333333333,A+
522325,174396,99,88,97,284,94.66666666666667,A+
522792,630386,94,93,88,275,91.66666666666667,A+
522793,212315,99,95,89,283,94.33333333333333,A+
522886,576276,95,92,84,271,90.33333333333333,A+
522927,611396,87,99,100,286,95.33333333333333,A+
522959,135510,93,95,94,282,94.0,A+
523259,613481,92,86,97,275,91.66666666666667,A+
523405,313272,88,100,90,278,92.66666666666667,A+
523495,217996,82,97,95,274,91.33333333333333,A+
523496,231758,91,99,84,274,91.33333333333333,A+
523743,159599,100,91,84,275,91.66666666666667,A+
524531,405252,84,98,93,275,91.66666666666667,A+
524644,874742,100,80,92,272,90.66666666666667,A+
524695,466351,92,99,92,283,94.33333333333333,A+
524812,966283,99,88,92,279,93.0,A+
524843,408212,98,81,98,277,92.33333333333333,A+
525063,332990,94,91,92,277,92.33333333333333,A+
525326,879842,85,93,99,277,92.33333333333333,A+
525372,43914,97,98,85,280,93.33333333333333,A+
525896,409276,94,100,99,293,97.66666666666667,A+
526126,521292,81,100,95,276,92.0,A+
526295,66739,95,94,94,283,94.33333333333333,A+
526594,135847,90,85,95,270,90.0,A+
526596,362809,95,97,99,291,97.0,A+
526896,398588,93,95,99,287,95.66666666666667,A+
526953,589855,95,92,86,273,91.0,A+
527205,816493,97,96,84,277,92.33333333333333,A+
527509,565760,94,85,93,272,90.66666666666667,A+
527683,652513,92,90,98,280,93.33333333333333,A+
528047,126852,85,100,87,272,90.66666666666667,A+
528074,235745,100,100,96,296,98.66666666666667,A+
528084,898905,100,85,92,277,92.33333333333333,A+
528087,209571,95,77,99,271,90.33333333333333,A+
529370,125630,85,99,98,282,94.0,A+
529492,397714,85,99,91,275,91.66666666666667,A+
529514,611891,96,99,93,288,96.0,A+
529560,626901,95,98,89,282,94.0,A+
529657,493784,98,90,86,274,91.33333333333333,A+
529788,835374,88,97,96,281,93.66666666666667,A+
529820,495960,100,100,73,273,91.0,A+
529948,943104,92,94,86,272,90.66666666666667,A+
530038,779350,98,96,99,293,97.66666666666667,A+
530099,268032,98,97,76,271,90.33333333333333,A+
530191,924218,100,88,95,283,94.33333333333333,A+
530255,661342,91,87,97,275,91.66666666666667,A+
530313,923729,100,88,99,287,95.66666666666667,A+
531012,680796,100,90,86,276,92.0,A+
531037,473076,73,100,98,271,90.33333333333333,A+
531387,942468,83,93,97,273,91.0,A+
531496,289042,96,93,99,288,96.0,A+
531599,288594,98,98,76,272,90.66666666666667,A+
531917,799435,93,78,99,270,90.0,A+
532092,841470,100,76,100,276,92.0,A+
532144,23653,95,86,92,273,91.0,A+
532153,106677,94,95,99,288,96.0,A+
532175,628118,94,95,99,288,96.0,A+
532280,781862,98,95,87,280,93.33333333333333,A+
532299,844629,96,96,80,272,90.66666666666667,A+
532323,641587,100,85,96,281,93.66666666666667,A+
532476,578294,94,87,96,277,92.33333333333333,A+
532729,372120,85,94,97,276,92.0,A+
533087,857079,93,86,95,274,91.33333333333333,A+
533354,585827,84,86,100,270,90.0,A+
533407,293547,89,100,86,275,91.66666666666667,A+
533498,834072,85,89,99,273,91.0,A+
533811,521640,96,89,90,275,91.66666666666667,A+
533883,531521,89,96,92,277,92.33333333333333,A+
534296,480413,98,89,88,275,91.66666666666667,A+
534397,19783,96,90,98,284,94.66666666666667,A+
534732,747367,90,95,88,273,91.0,A+
534958,516052,96,87,92,275,91.66666666666667,A+
535050,8581,89,99,90,278,92.66666666666667,A+
535236,1003524,96,83,100,279,93.0,A+
535244,240135,98,93,99,290,96.66666666666667,A+
535864,1010310,99,95,93,287,95.66666666666667,A+
535867,562141,89,100,100,289,96.33333333333333,A+
535909,510861,98,95,87,280,93.33333333333333,A+
535927,632348,95,100,91,286,95.33333333333333,A+
535972,738954,90,96,96,282,94.0,A+
536059,114313,100,83,100,283,94.33333333333333,A+
536395,56406,88,99,96,283,94.33333333333333,A+
536478,729495,99,91,82,272,90.66666666666667,A+
537069,1048077,97,91,90,278,92.66666666666667,A+
537102,764994,97,89,90,276,92.0,A+
537223,501366,91,100,84,275,91.66666666666667,A+
537247,303899,93,81,99,273,91.0,A+
537451,290056,97,94,84,275,91.66666666666667,A+
537684,162706,92,96,92,280,93.33333333333333,A+
537920,633009,95,98,97,290,96.66666666666667,A+
538394,319202,95,92,86,273,91.0,A+
538652,587936,95,93,96,284,94.66666666666667,A+
538824,539268,88,93,98,279,93.0,A+
539138,369270,95,100,87,282,94.0,A+
539854,143678,93,94,88,275,91.66666666666667,A+
539892,1011875,90,95,85,270,90.0,A+
540220,855978,96,99,87,282,94.0,A+
540313,33491,93,81,97,271,90.33333333333333,A+
540353,721076,90,92,94,276,92.0,A+
540575,821867,89,100,82,271,90.33333333333333,A+
540600,119375,92,89,91,272,90.66666666666667,A+
540981,1005449,90,93,92,275,91.66666666666667,A+
541001,787757,89,96,94,279,93.0,A+
541004,884623,92,86,93,271,90.33333333333333,A+
541514,546953,96,92,92,280,93.33333333333333,A+
541579,1035641,72,100,98,270,90.0,A+
541712,167763,99,87,99,285,95.0,A+
541903,692982,100,92,89,281,93.66666666666667,A+
542222,153730,100,88,95,283,94.33333333333333,A+
542242,1022416,97,89,88,274,91.33333333333333,A+
542302,675667,93,97,92,282,94.0,A+
542459,1036184,100,100,79,279,93.0,A+
542530,719162,91,97,84,272,90.66666666666667,A+
542555,260207,89,97,86,272,90.66666666666667,A+
542618,1004361,96,83,96,275,91.66666666666667,A+
542639,680852,97,79,95,271,90.33333333333333,A+
542672,37887,100,74,97,271,90.33333333333333,A+
543055,535422,86,89,99,274,91.33333333333333,A+
543395,217800,100,98,85,283,94.33333333333333,A+
543529,160107,97,79,95,271,90.33333333333333,A+
543659,575084,86,93,91,270,90.0,A+
543754,635173,95,97,84,276,92.0,A+
543951,161654,84,98,95,277,92.33333333333333,A+
544066,167451,84,99,98,281,93.66666666666667,A+
544403,839886,97,100,98,295,98.33333333333333,A+
544678,501470,91,100,86,277,92.33333333333333,A+
544953,727508,99,94,85,278,92.66666666666667,A+
544956,853490,94,91,94,279,93.0,A+
544963,1031257,99,96,87,282,94.0,A+
545276,142486,99,85,90,274,91.33333333333333,A+
545547,272050,99,100,85,284,94.66666666666667,A+
545575,493712,97,88,98,283,94.33333333333333,A+
545678,919546,94,98,82,274,91.33333333333333,A+
545700,851050,95,94,95,284,94.66666666666667,A+
545727,30781,88,98,88,274,91.33333333333333,A+
545876,976273,100,94,93,287,95.66666666666667,A+
546123,52150,96,96,86,278,92.66666666666667,A+
546509,512603,98,93,86,277,92.33333333333333,A+
546516,959961,98,86,100,284,94.66666666666667,A+
546644,208770,95,79,97,271,90.33333333333333,A+
546699,853177,95,93,88,276,92.0,A+
546874,281612,98,97,78,273,91.0,A+
547147,641526,94,97,90,281,93.66666666666667,A+
547349,552920,88,96,87,271,90.33333333333333,A+
547630,930956,85,99,100,284,94.66666666666667,A+
547648,841873,96,97,95,288,96.0,A+
547899,422733,97,80,98,275,91.66666666666667,A+
548028,222642,98,90,90,278,92.66666666666667,A+
548166,851471,96,96,82,274,91.33333333333333,A+
548487,792373,98,98,97,293,97.66666666666667,A+
548585,897255,83,88,100,271,90.33333333333333,A+
548773,143153,92,93,98,283,94.33333333333333,A+
548894,786559,86,87,99,272,90.66666666666667,A+
549144,147133,100,88,90,278,92.66666666666667,A+
549234,418593,93,97,95,285,95.0,A+
549272,464101,96,81,95,272,90.66666666666667,A+
549434,266284,90,100,80,270,90.0,A+
549505,320945,79,100,91,270,90.0,A+
549664,241351,89,93,91,273,91.0,A+
550110,534939,96,88,100,284,94.66666666666667,A+
550324,44960,97,97,85,279,93.0,A+
550334,414705,98,81,100,279,93.0,A+
550530,783006,88,94,91,273,91.0,A+
550622,444731,90,90,93,273,91.0,A+
550960,601692,95,95,88,278,92.66666666666667,A+
551152,285208,98,98,100,296,98.66666666666667,A+
551350,825914,96,93,82,271,90.33333333333333,A+
551558,988691,82,96,99,277,92.33333333333333,A+
551651,461355,91,96,92,279,93.0,A+
551697,255530,97,93,88,278,92.66666666666667,A+
551726,684428,93,97,84,274,91.33333333333333,A+
551897,561510,96,93,86,275,91.66666666666667,A+
553243,897834,95,100,80,275,91.66666666666667,A+
553277,218595,91,96,90,277,92.33333333333333,A+
553282,330586,95,95,86,276,92.0,A+
553737,7818,98,97,100,295,98.33333333333333,A+
553972,294612,100,75,95,270,90.0,A+
553994,516517,98,96,93,287,95.66666666666667,A+
554079,827927,85,88,97,270,90.0,A+
554192,295950,87,95,91,273,91.0,A+
554504,317864,77,93,100,270,90.0,A+
554707,98227,86,99,96,281,93.66666666666667,A+
555672,891060,95,98,87,280,93.33333333333333,A+
555688,712346,97,84,94,275,91.66666666666667,A+
556070,79750,77,96,98,271,90.33333333333333,A+
556090,868683,96,98,99,293,97.66666666666667,A+
556369,540558,87,92,95,274,91.33333333333333,A+
556908,737689,73,99,98,270,90.0,A+
557018,764542,82,100,93,275,91.66666666666667,A+
557029,938420,91,89,91,271,90.33333333333333,A+
557110,953602,90,87,97,274,91.33333333333333,A+
557310,445141,96,78,99,273,91.0,A+
557389,697091,98,84,100,282,94.0,A+
557459,559230,94,84,97,275,91.66666666666667,A+
557566,17062,89,97,90,276,92.0,A+
557983,307371,88,100,86,274,91.33333333333333,A+
558048,106884,86,99,85,270,90.0,A+
558284,155687,92,95,100,287,95.66666666666667,A+
558489,1045570,98,96,83,277,92.33333333333333,A+
558561,361543,93,89,96,278,92.66666666666667,A+
558697,1035231,97,91,82,270,90.0,A+
558721,523249,89,97,96,282,94.0,A+
559324,973724,92,98,94,284,94.66666666666667,A+
559511,596526,88,100,100,288,96.0,A+
559611,697929,98,84,96,278,92.66666666666667,A+
559628,61707,94,90,100,284,94.66666666666667,A+
559816,1041443,97,90,92,279,93.0,A+
560009,494481,97,89,86,272,90.66666666666667,A+
560043,436844,91,92,92,275,91.66666666666667,A+
560571,526245,88,92,100,280,93.33333333333333,A+
560880,659960,94,99,97,290,96.66666666666667,A+
560958,892969,85,94,99,278,92.66666666666667,A+
561330,952453,75,99,100,274,91.33333333333333,A+
561663,679745,92,92,90,274,91.33333333333333,A+
561686,1008488,82,100,91,273,91.0,A+
561757,1032052,89,95,92,276,92.0,A+
561849,836596,88,98,85,271,90.33333333333333,A+
561878,161733,93,100,80,273,91.0,A+
562013,675716,96,76,99,271,90.33333333333333,A+
562354,908229,93,93,90,276,92.0,A+
562404,214927,98,89,99,286,95.33333333333333,A+
562406,176738,92,95,96,283,94.33333333333333,A+
562648,828984,88,97,96,281,93.66666666666667,A+
562852,1021530,94,78,99,271,90.33333333333333,A+
562863,973828,92,97,97,286,95.33333333333333,A+
563018,156873,92,94,96,282,94.0,A+
563025,973613,99,88,90,277,92.33333333333333,A+
563095,611854,95,98,99,292,97.33333333333333,A+
563431,525131,89,95,92,276,92.0,A+
563495,682991,99,87,88,274,91.33333333333333,A+
563726,784578,96,89,98,283,94.33333333333333,A+
563850,4589,79,94,98,271,90.33333333333333,A+
563853,342424,96,98,89,283,94.33333333333333,A+
563921,1017573,99,96,83,278,92.66666666666667,A+
564131,171352,97,82,100,279,93.0,A+
564218,551832,94,86,91,271,90.33333333333333,A+
564296,744859,92,100,80,272,90.66666666666667,A+
564335,584768,97,100,83,280,93.33333333333333,A+
564486,900507,99,82,96,277,92.33333333333333,A+
564774,333094,94,90,94,278,92.66666666666667,A+
564794,501996,99,97,93,289,96.33333333333333,A+
564830,573139,96,96,84,276,92.0,A+
564941,1029851,81,99,93,273,91.0,A+
565109,145134,82,91,99,272,90.66666666666667,A+
565132,318787,88,100,100,288,96.0,A+
565205,884916,95,98,84,277,92.33333333333333,A+
565221,758709,97,88,92,277,92.33333333333333,A+
565927,841799,88,99,90,277,92.33333333333333,A+
566035,911574,76,98,98,272,90.66666666666667,A+
566293,667768,76,100,96,272,90.66666666666667,A+
566306,312881,94,89,94,277,92.33333333333333,A+
566581,546250,87,94,95,276,92.0,A+
566585,744604,97,86,100,283,94.33333333333333,A+
566711,175937,92,97,94,283,94.33333333333333,A+
566747,334103,93,88,100,281,93.66666666666667,A+
566879,204343,97,84,100,281,93.66666666666667,A+
566912,511381,98,93,97,288,96.0,A+
567204,336555,95,94,99,288,96.0,A+
567280,211912,87,84,99,270,90.0,A+
567345,367516,93,92,88,273,91.0,A+
567370,384153,97,75,99,271,90.33333333333333,A+
567498,1022464,100,100,81,281,93.66666666666667,A+
568042,556411,95,91,84,270,90.0,A+
568209,125618,83,89,99,271,90.33333333333333,A+
568211,178719,97,83,92,272,90.66666666666667,A+
568469,551936,94,85,93,272,90.66666666666667,A+
568643,749281,89,91,97,277,92.33333333333333,A+
568760,306351,94,88,98,280,93.33333333333333,A+
568785,645910,99,80,91,270,90.0,A+
568968,917327,98,77,99,274,91.33333333333333,A+
569097,591433,96,98,95,289,96.33333333333333,A+
569195,693960,100,93,80,273,91.0,A+
569356,312043,95,90,98,283,94.33333333333333,A+
569585,20712,93,80,97,270,90.0,A+
569702,183818,98,85,94,277,92.33333333333333,A+
569850,663928,99,84,90,273,91.0,A+
569983,677257,90,85,97,272,90.66666666666667,A+
570330,994493,91,97,98,286,95.33333333333333,A+
570406,597253,94,90,92,276,92.0,A+
570777,132930,94,98,99,291,97.0,A+
571084,713159,100,92,95,287,95.66666666666667,A+
571101,614844,100,83,100,283,94.33333333333333,A+
571149,334176,94,90,88,272,90.66666666666667,A+
571280,456298,100,95,81,276,92.0,A+
571301,992432,99,91,91,281,93.66666666666667,A+
571571,70689,96,98,95,289,96.33333333333333,A+
571632,398104,94,99,82,275,91.66666666666667,A+
571655,796445,88,93,98,279,93.0,A+
571825,645684,95,100,95,290,96.66666666666667,A+
572044,151731,98,80,98,276,92.0,A+
572222,96233,93,91,96,280,93.33333333333333,A+
572323,544599,85,86,99,270,90.0,A+
572659,726212,91,95,90,276,92.0,A+
572673,29657,94,86,98,278,92.66666666666667,A+
572718,633388,86,99,94,279,93.0,A+
573134,880862,94,94,82,270,90.0,A+
573697,26649,78,92,100,270,90.0,A+
573815,37213,98,99,79,276,92.0,A+
574281,924493,76,100,95,271,90.33333333333333,A+
574285,958243,81,90,100,271,90.33333333333333,A+
574366,394711,93,93,86,272,90.66666666666667,A+
574422,511125,95,83,100,278,92.66666666666667,A+
574631,261992,98,96,76,270,90.0,A+
574709,898630,86,99,85,270,90.0,A+
575296,197201,100,96,91,287,95.66666666666667,A+
575591,223492,100,99,85,284,94.66666666666667,A+
575594,69747,96,99,97,292,97.33333333333333,A+
576370,57666,96,96,97,289,96.33333333333333,A+
576427,298604,95,90,92,277,92.33333333333333,A+
576656,368378,99,79,96,274,91.33333333333333,A+
576703,640077,98,77,95,270,90.0,A+
576775,973405,99,89,86,274,91.33333333333333,A+
576783,919706,75,97,98,270,90.0,A+
577192,391386,91,86,97,274,91.33333333333333,A+
577351,258594,96,86,100,282,94.0,A+
577483,89630,85,92,95,272,90.66666666666667,A+
577838,849516,96,96,99,291,97.0,A+
578178,207455,90,93,87,270,90.0,A+
578269,467836,88,87,95,270,90.0,A+
578813,836638,97,98,76,271,90.33333333333333,A+
578821,421063,99,85,86,270,90.0,A+
579052,552737,94,84,95,273,91.0,A+
579201,332017,95,95,80,270,90.0,A+
579609,568554,86,92,95,273,91.0,A+
579625,863547,87,99,85,271,90.33333333333333,A+
579689,24320,88,94,100,282,94.0,A+
579779,995545,100,96,95,291,97.0,A+
579931,106639,86,99,87,272,90.66666666666667,A+
579988,641269,76,98,98,272,90.66666666666667,A+
580181,172892,91,91,98,280,93.33333333333333,A+
580322,651436,93,94,84,271,90.33333333333333,A+
580477,473222,98,90,86,274,91.33333333333333,A+
580793,329364,95,95,97,287,95.66666666666667,A+
581192,279100,98,98,91,287,95.66666666666667,A+
581217,873550,91,81,99,271,90.33333333333333,A+
581298,450533,99,91,93,283,94.33333333333333,A+
581419,815587,98,98,81,277,92.33333333333333,A+
581617,252632,90,98,90,278,92.66666666666667,A+
581825,263381,96,90,96,282,94.0,A+
581875,363780,86,97,93,276,92.0,A+
581963,495222,99,95,99,293,97.66666666666667,A+
581967,336126,93,87,91,271,90.33333333333333,A+
582011,907776,93,94,88,275,91.66666666666667,A+
582013,674022,100,89,93,282,94.0,A+
582432,186056,91,93,92,276,92.0,A+
582512,312672,95,90,90,275,91.66666666666667,A+
582559,321195,88,100,86,274,91.33333333333333,A+
582780,139998,97,77,97,271,90.33333333333333,A+
582785,42961,79,100,93,272,90.66666666666667,A+
582810,841946,97,100,83,280,93.33333333333333,A+
582895,106248,77,98,96,271,90.33333333333333,A+
582951,298672,95,89,100,284,94.66666666666667,A+
583224,313431,100,78,96,274,91.33333333333333,A+
583431,908541,93,91,96,280,93.33333333333333,A+
583446,555385,92,79,99,270,90.0,A+
583770,298598,86,91,95,272,90.66666666666667,A+
583801,620688,96,99,78,273,91.0,A+
584081,265362,87,88,97,272,90.66666666666667,A+
584234,570719,94,87,100,281,93.66666666666667,A+
584325,579871,87,97,87,271,90.33333333333333,A+
584658,736655,92,100,93,285,95.0,A+
585309,525620,89,95,87,271,90.33333333333333,A+
585402,857427,77,96,100,273,91.0,A+
585542,800431,89,98,92,279,93.0,A+
585655,705760,100,94,89,283,94.33333333333333,A+
585866,971724,90,90,98,278,92.66666666666667,A+
585955,443275,100,93,83,276,92.0,A+
586088,34230,86,92,93,271,90.33333333333333,A+
586219,861615,84,90,97,271,90.33333333333333,A+
586361,251696,99,98,89,286,95.33333333333333,A+
586399,331547,92,82,99,273,91.0,A+
586561,339581,100,80,94,274,91.33333333333333,A+
586980,394639,92,91,98,281,93.66666666666667,A+
587011,1022973,81,98,97,276,92.0,A+
587358,470611,100,95,76,271,90.33333333333333,A+
587427,978823,92,100,97,289,96.33333333333333,A+
587898,647616,98,76,97,271,90.33333333333333,A+
587943,959655,92,98,97,287,95.66666666666667,A+
588169,357489,76,96,98,270,90.0,A+
588194,871336,95,97,82,274,91.33333333333333,A+
588522,155259,75,98,98,271,90.33333333333333,A+
588738,696290,98,86,98,282,94.0,A+
588767,974415,83,97,97,277,92.33333333333333,A+
588869,433083,93,99,80,272,90.66666666666667,A+
589046,854046,94,89,98,281,93.66666666666667,A+
589297,682679,84,99,87,270,90.0,A+
589879,1021224,88,90,95,273,91.0,A+
590597,76711,84,90,99,273,91.0,A+
590635,508452,91,100,84,275,91.66666666666667,A+
590807,719474,91,95,90,276,92.0,A+
590889,230395,90,98,98,286,95.33333333333333,A+
590982,408884,92,93,86,271,90.33333333333333,A+
591080,154574,93,98,93,284,94.66666666666667,A+
591345,176952,100,94,97,291,97.0,A+
591514,585850,97,100,76,273,91.0,A+
591536,292068,86,89,99,274,91.33333333333333,A+
591550,744897,100,97,91,288,96.0,A+
591944,155484,94,100,76,270,90.0,A+
592029,130265,83,92,99,274,91.33333333333333,A+
592083,799698,89,98,98,285,95.0,A+
592214,330893,86,94,95,275,91.66666666666667,A+
592406,449769,100,94,85,279,93.0,A+
592637,235391,91,100,99,290,96.66666666666667,A+
592694,812274,98,100,91,289,96.33333333333333,A+
592811,160364,100,89,93,282,94.0,A+
592814,163188,99,86,86,271,90.33333333333333,A+
592961,382221,95,99,97,291,97.0,A+
593156,857720,96,96,86,278,92.66666666666667,A+
593161,966185,93,99,93,285,95.0,A+
593270,581639,92,81,99,272,90.66666666666667,A+
593541,975710,91,96,92,279,93.0,A+
593764,151383,98,81,98,277,92.33333333333333,A+
593819,61395,95,91,94,280,93.33333333333333,A+
593914,147928,90,87,95,272,90.66666666666667,A+
594013,26453,96,92,90,278,92.66666666666667,A+
594676,681347,75,100,99,274,91.33333333333333,A+
594714,1038753,89,94,98,281,93.66666666666667,A+
594827,291450,96,92,84,272,90.66666666666667,A+
594872,681103,91,89,95,275,91.66666666666667,A+
595260,470490,96,82,95,273,91.0,A+
595315,364300,100,84,98,282,94.0,A+
595337,457265,90,92,96,278,92.66666666666667,A+
595773,626754,86,98,96,280,93.33333333333333,A+
595904,693881,91,91,96,278,92.66666666666667,A+
596153,196180,83,99,91,273,91.0,A+
596194,893708,94,94,90,278,92.66666666666667,A+
596212,862563,78,99,97,274,91.33333333333333,A+
596679,844697,96,95,88,279,93.0,A+
596743,188990,99,89,84,272,90.66666666666667,A+
596825,1009374,100,100,75,275,91.66666666666667,A+
596909,417193,84,100,98,282,94.0,A+
597223,865675,94,93,96,283,94.33333333333333,A+
597225,843463,93,84,99,276,92.0,A+
597319,743937,88,89,97,274,91.33333333333333,A+
597642,1008940,97,88,88,273,91.0,A+
597882,359280,94,94,86,274,91.33333333333333,A+
597906,807579,95,86,98,279,93.0,A+
597978,584830,87,99,94,280,93.33333333333333,A+
598255,12488,96,92,94,282,94.0,A+
598568,981745,82,97,95,274,91.33333333333333,A+
599454,979831,99,91,80,270,90.0,A+
599780,979758,99,89,92,280,93.33333333333333,A+
600346,212866,90,94,96,280,93.33333333333333,A+
600553,664,99,99,91,289,96.33333333333333,A+
600592,570162,94,88,96,278,92.66666666666667,A+
600666,745478,97,87,90,274,91.33333333333333,A+
600959,299417,97,99,93,289,96.33333333333333,A+
601264,445636,89,88,97,274,91.33333333333333,A+
602092,357697,92,84,97,273,91.0,A+
602851,729771,83,99,100,282,94.0,A+
602971,303,81,100,97,278,92.66666666666667,A+
602989,285734,98,99,89,286,95.33333333333333,A+
603357,51613,93,85,98,276,92.0,A+
603744,345163,76,94,100,270,90.0,A+
604369,454342,92,99,80,271,90.33333333333333,A+
604756,565105,88,98,90,276,92.0,A+
604853,82978,96,99,99,294,98.0,A+
605393,946949,93,98,84,275,91.66666666666667,A+
605557,918733,100,85,99,284,94.66666666666667,A+
605712,442738,82,93,99,274,91.33333333333333,A+
605998,432588,84,99,87,270,90.0,A+
606025,100110,86,97,91,274,91.33333333333333,A+
606032,169047,89,86,99,274,91.33333333333333,A+
606068,746731,96,84,94,274,91.33333333333333,A+
606177,119271,92,89,89,270,90.0,A+
606250,1042238,87,89,97,273,91.0,A+
606615,217519,100,96,93,289,96.33333333333333,A+
606644,501855,99,96,97,292,97.33333333333333,A+
607101,589574,94,91,94,279,93.0,A+
607108,188673,98,87,98,283,94.33333333333333,A+
607118,6907,90,100,99,289,96.33333333333333,A+
607135,335019,87,100,86,273,91.0,A+
607476,989987,91,95,94,280,93.33333333333333,A+
607602,830561,97,96,82,275,91.66666666666667,A+
607888,256282,94,80,97,271,90.33333333333333,A+
607946,312929,97,100,87,284,94.66666666666667,A+
607971,1044971,89,97,88,274,91.33333333333333,A+
608018,128180,93,95,96,284,94.66666666666667,A+
608115,113965,100,84,100,284,94.66666666666667,A+
608266,71141,96,97,97,290,96.66666666666667,A+
608385,328209,87,97,98,282,94.0,A+
608434,753157,81,97,93,271,90.33333333333333,A+
608713,112950,92,87,97,276,92.0,A+
608714,820945,85,88,99,272,90.66666666666667,A+
609014,36223,95,89,88,272,90.66666666666667,A+
609056,730951,73,99,98,270,90.0,A+
609074,23054,86,87,97,270,90.0,A+
609132,961881,83,96,95,274,91.33333333333333,A+
609429,538112,95,85,94,274,91.33333333333333,A+
609563,377579,95,100,76,271,90.33333333333333,A+
609603,846049,86,92,97,275,91.66666666666667,A+
609752,491449,98,93,89,280,93.33333333333333,A+
609847,1008904,97,87,94,278,92.66666666666667,A+
609856,874113,100,79,100,279,93.0,A+
610331,11675,94,83,93,270,90.0,A+
610508,1043430,81,99,95,275,91.66666666666667,A+
610566,828379,85,87,99,271,90.33333333333333,A+
610661,411085,85,100,89,274,91.33333333333333,A+
611013,83491,94,91,90,275,91.66666666666667,A+
611056,988984,100,97,85,282,94.0,A+
611099,645195,95,100,99,294,98.0,A+
611196,706702,100,93,87,280,93.33333333333333,A+
611290,814782,97,95,99,291,97.0,A+
611309,825389,95,92,92,279,93.0,A+
611507,460768,100,96,91,287,95.66666666666667,A+
611556,574350,86,93,97,276,92.0,A+
611759,889716,99,78,93,270,90.0,A+
612025,252980,89,97,90,276,92.0,A+
612356,13033,93,80,99,272,90.66666666666667,A+
612582,464290,99,93,84,276,92.0,A+
612706,696180,90,87,99,276,92.0,A+
612825,1030726,89,95,100,284,94.66666666666667,A+
612863,561089,95,91,98,284,94.66666666666667,A+
612895,381267,92,90,100,282,94.0,A+
612948,330098,95,95,90,280,93.33333333333333,A+
613063,100250,86,98,87,271,90.33333333333333,A+
613650,544403,88,97,94,279,93.0,A+
613998,582384,95,92,92,279,93.0,A+
614085,155363,75,97,100,272,90.66666666666667,A+
614148,491032,99,95,80,274,91.33333333333333,A+
614302,452759,74,100,96,270,90.0,A+
614469,911867,94,99,84,277,92.33333333333333,A+
614534,934899,92,93,98,283,94.33333333333333,A+
614965,538522,100,73,99,272,90.66666666666667,A+
615144,219438,99,96,83,278,92.66666666666667,A+
615200,130760,92,92,92,276,92.0,A+
615364,301269,98,100,74,272,90.66666666666667,A+
615552,728309,99,92,86,277,92.33333333333333,A+
615750,1023119,90,98,90,278,92.66666666666667,A+
615784,748021,80,94,97,271,90.33333333333333,A+
616337,488050,88,88,95,271,90.33333333333333,A+
616418,328508,99,75,99,273,91.0,A+
616600,305941,89,100,92,281,93.66666666666667,A+
617320,887765,84,92,95,271,90.33333333333333,A+
617328,622560,85,94,97,276,92.0,A+
617400,385039,100,86,88,274,91.33333333333333,A+
617572,243559,91,100,92,283,94.33333333333333,A+
617982,407141,93,95,86,274,91.33333333333333,A+
618304,272081,98,97,99,294,98.0,A+
618314,164937,92,94,88,274,91.33333333333333,A+
618419,102929,99,80,100,279,93.0,A+
618650,307866,97,99,79,275,91.66666666666667,A+
618769,1023113,81,98,93,272,90.66666666666667,A+
618822,184912,100,95,87,282,94.0,A+
619265,122169,100,85,88,273,91.0,A+
619395,947109,90,86,95,271,90.33333333333333,A+
620057,639178,92,90,94,276,92.0,A+
620793,117529,93,92,90,275,91.66666666666667,A+
621015,934098,92,95,96,283,94.33333333333333,A+
621185,700208,100,93,85,278,92.66666666666667,A+
621198,373930,99,80,100,279,93.0,A+
621434,306736,79,99,97,275,91.66666666666667,A+
621549,473773,73,99,98,270,90.0,A+
621817,776024,88,93,93,274,91.33333333333333,A+
622015,602077,95,95,82,272,90.66666666666667,A+
622461,41671,95,91,90,276,92.0,A+
622475,197434,82,97,95,274,91.33333333333333,A+
622498,153737,93,98,97,288,96.0,A+
622838,231263,97,88,86,271,90.33333333333333,A+
622965,33038,78,93,100,271,90.33333333333333,A+
623013,996688,90,94,100,284,94.66666666666667,A+
623089,71416,87,98,92,277,92.33333333333333,A+
623403,231972,99,97,85,281,93.66666666666667,A+
623584,1044867,89,98,86,273,91.0,A+
623698,561015,87,93,93,273,91.0,A+
623881,36266,89,100,84,273,91.0,A+
623995,655937,85,97,91,273,91.0,A+
624097,693318,82,93,95,270,90.0,A+
624356,110895,93,91,92,276,92.0,A+
624427,1042531,90,100,88,278,92.66666666666667,A+
624626,128106,100,86,86,272,90.66666666666667,A+
624839,1039737,98,94,86,278,92.66666666666667,A+
625201,48060,95,91,90,276,92.0,A+
625210,258220,90,100,88,278,92.66666666666667,A+
625397,161446,84,99,91,274,91.33333333333333,A+
625587,769488,95,81,95,271,90.33333333333333,A+
626034,919265,94,97,90,281,93.66666666666667,A+
626736,842460,87,97,96,280,93.33333333333333,A+
626868,235024,95,81,97,273,91.0,A+
626876,109042,85,94,93,272,90.66666666666667,A+
626880,782921,100,71,99,270,90.0,A+
627473,565418,87,96,96,279,93.0,A+
627986,400403,93,95,86,274,91.33333333333333,A+
628581,722477,83,100,96,279,93.0,A+
628722,803177,78,94,100,272,90.66666666666667,A+
629157,108241,85,96,91,272,90.66666666666667,A+
629181,1012842,80,92,100,272,90.66666666666667,A+
629206,637044,99,81,98,278,92.66666666666667,A+
629242,904695,91,87,97,275,91.66666666666667,A+
629948,526770,88,93,89,270,90.0,A+
629964,53159,96,94,92,282,94.0,A+
630003,684740,92,95,90,277,92.33333333333333,A+
630128,283520,87,93,91,271,90.33333333333333,A+
630138,767440,89,96,92,277,92.33333333333333,A+
630170,261418,95,84,93,272,90.66666666666667,A+
630581,151914,92,92,90,274,91.33333333333333,A+
630585,391740,100,85,94,279,93.0,A+
630759,363836,98,75,97,270,90.0,A+
630775,340357,94,92,84,270,90.0,A+
631312,592050,94,89,87,270,90.0,A+
631317,406616,92,94,96,282,94.0,A+
631361,654445,94,99,87,280,93.33333333333333,A+
631378,45016,78,96,99,273,91.0,A+
631430,789395,88,94,91,273,91.0,A+
631545,838584,95,91,100,286,95.33333333333333,A+
631711,348843,87,100,86,273,91.0,A+
632053,525382,98,95,87,280,93.33333333333333,A+
632118,508947,100,100,77,277,92.33333333333333,A+
632383,508581,96,87,98,281,93.66666666666667,A+
632580,773272,90,98,88,276,92.0,A+
632668,755108,80,94,96,270,90.0,A+
633317,18517,78,94,100,272,90.66666666666667,A+
633893,176377,89,86,97,272,90.66666666666667,A+
634420,431048,91,91,89,271,90.33333333333333,A+
634565,459747,98,89,86,273,91.0,A+
634819,158922,97,80,100,277,92.33333333333333,A+
635090,739743,87,84,99,270,90.0,A+
635258,294416,88,96,96,280,93.33333333333333,A+
635313,598452,96,99,87,282,94.0,A+
635520,239957,89,95,92,276,92.0,A+
635551,359195,91,82,99,272,90.66666666666667,A+
635666,711795,91,96,92,279,93.0,A+
635734,39085,87,94,97,278,92.66666666666667,A+
635831,633632,86,99,92,277,92.33333333333333,A+
635867,916214,83,91,97,271,90.33333333333333,A+
636132,754062,81,95,97,273,91.0,A+
636150,931230,91,90,89,270,90.0,A+
636306,119932,91,87,95,273,91.0,A+
636426,301893,97,96,87,280,93.33333333333333,A+
636987,895756,99,80,94,273,91.0,A+
636991,285893,95,87,100,282,94.0,A+
637121,395861,92,91,87,270,90.0,A+
637254,660687,85,100,94,279,93.0,A+
637716,558061,98,99,81,278,92.66666666666667,A+
637993,1038203,98,95,91,284,94.66666666666667,A+
638578,70322,100,78,94,272,90.66666666666667,A+
638938,405118,93,97,95,285,95.0,A+
639219,322308,87,97,94,278,92.66666666666667,A+
639327,765287,100,100,81,281,93.66666666666667,A+
639897,274978,98,96,80,274,91.33333333333333,A+
639998,505413,98,94,84,276,92.0,A+
640044,885717,95,96,86,277,92.33333333333333,A+
640072,653852,94,100,89,283,94.33333333333333,A+
640177,392676,90,85,95,270,90.0,A+
640286,245135,100,100,79,279,93.0,A+
640354,948020,98,84,96,278,92.66666666666667,A+
640556,489077,99,95,97,291,97.0,A+
640723,789682,98,95,80,273,91.0,A+
640774,829883,93,84,97,274,91.33333333333333,A+
640942,1034804,88,90,97,275,91.66666666666667,A+
641223,295290,88,97,85,270,90.0,A+
641339,896924,95,98,97,290,96.66666666666667,A+
641383,619411,83,88,99,270,90.0,A+
641404,224110,90,96,100,286,95.33333333333333,A+
641662,743693,88,89,99,276,92.0,A+
641824,675655,75,98,98,271,90.33333333333333,A+
641827,428431,91,92,100,283,94.33333333333333,A+
642022,640529,98,76,97,271,90.33333333333333,A+
642039,963140,91,93,96,280,93.33333333333333,A+
642321,212554,90,95,90,275,91.66666666666667,A+
642322,256404,98,94,78,270,90.0,A+
642396,839556,86,92,95,273,91.0,A+
642443,475418,82,97,93,272,90.66666666666667,A+
642665,6240,97,92,90,279,93.0,A+
642924,1014424,98,91,84,273,91.0,A+
643193,737040,92,100,86,278,92.66666666666667,A+
643887,299020,95,88,100,283,94.33333333333333,A+
643959,780156,99,99,81,279,93.0,A+
643963,436257,100,92,91,283,94.33333333333333,A+
644466,1007969,91,98,99,288,96.0,A+
645053,862282,93,87,100,280,93.33333333333333,A+
645254,1039731,89,94,89,272,90.66666666666667,A+
645255,483286,100,97,75,272,90.66666666666667,A+
645490,357537,95,97,86,278,92.66666666666667,A+
645512,25792,97,95,84,276,92.0,A+
645838,330654,95,94,94,283,94.33333333333333,A+
645987,135156,100,85,92,277,92.33333333333333,A+
645988,762646,95,82,93,270,90.0,A+
646527,173497,93,100,95,288,96.0,A+
646706,855421,97,100,83,280,93.33333333333333,A+
647004,306980,94,89,90,273,91.0,A+
647968,75464,94,92,92,278,92.66666666666667,A+
648211,79463,98,74,99,271,90.33333333333333,A+
648510,53258,86,93,97,276,92.0,A+
648882,677477,92,93,100,285,95.0,A+
648932,290607,87,93,91,271,90.33333333333333,A+
649021,269635,97,94,80,271,90.33333333333333,A+
649051,246383,90,97,86,273,91.0,A+
649859,764309,100,100,89,289,96.33333333333333,A+
650064,655894,91,86,95,272,90.66666666666667,A+
650140,799288,99,100,87,286,95.33333333333333,A+
650389,524288,95,85,94,274,91.33333333333333,A+
650563,942817,83,93,97,273,91.0,A+
650676,1016351,99,96,93,288,96.0,A+
650706,411439,94,99,86,279,93.0,A+
651144,342944,95,95,99,289,96.33333333333333,A+
651601,772813,97,89,84,270,90.0,A+
651820,1003572,99,95,93,287,95.66666666666667,A+
652310,572681,88,98,85,271,90.33333333333333,A+
652351,745093,97,86,96,279,93.0,A+
652356,679292,92,93,88,273,91.0,A+
653269,796212,98,97,76,271,90.33333333333333,A+
653357,408945,83,92,97,272,90.66666666666667,A+
653621,819978,96,91,84,271,90.33333333333333,A+
653684,482571,96,84,96,276,92.0,A+
653820,604438,84,90,97,271,90.33333333333333,A+
653937,279296,95,87,96,278,92.66666666666667,A+
654032,408046,92,93,90,275,91.66666666666667,A+
654120,1015489,94,77,99,270,90.0,A+
654174,609635,91,81,99,271,90.33333333333333,A+
654204,230670,82,99,93,274,91.33333333333333,A+
654467,527797,99,100,92,291,97.0,A+
654639,208812,89,90,93,272,90.66666666666667,A+
655295,542973,89,97,100,286,95.33333333333333,A+
655383,451543,99,88,99,286,95.33333333333333,A+
655586,417676,75,100,96,271,90.33333333333333,A+
655629,255488,88,92,97,277,92.33333333333333,A+
655707,278287,80,100,95,275,91.66666666666667,A+
655829,606932,96,97,87,280,93.33333333333333,A+
655990,397335,94,98,95,287,95.66666666666667,A+
656071,767513,98,94,97,289,96.33333333333333,A+
656201,454477,91,95,96,282,94.0,A+
656287,362667,87,100,85,272,90.66666666666667,A+
656966,63584,100,78,94,272,90.66666666666667,A+
656987,49375,100,77,100,277,92.33333333333333,A+
657195,766052,99,97,89,285,95.0,A+
657288,295712,97,95,91,283,94.33333333333333,A+
657810,723131,89,88,99,276,92.0,A+
657880,494201,81,99,99,279,93.0,A+
657980,473962,92,100,82,274,91.33333333333333,A+
658340,789994,97,94,86,277,92.33333333333333,A+
658421,867510,91,80,99,270,90.0,A+
658474,369919,92,88,93,273,91.0,A+
659064,163819,92,93,100,285,95.0,A+
659266,863162,87,98,92,277,92.33333333333333,A+
659392,439289,99,88,88,275,91.66666666666667,A+
659556,779942,90,100,80,270,90.0,A+
659662,608638,95,94,92,281,93.66666666666667,A+
659811,805971,86,90,97,273,91.0,A+
660101,834463,79,100,95,274,91.33333333333333,A+
660422,179416,82,92,97,271,90.33333333333333,A+
660441,484326,98,92,95,285,95.0,A+
660447,719823,91,95,90,276,92.0,A+
660538,793804,98,97,91,286,95.33333333333333,A+
660762,796482,88,94,91,273,91.0,A+
661085,890804,77,99,94,270,90.0,A+
661459,660290,98,78,95,271,90.33333333333333,A+
661679,711972,92,97,82,271,90.33333333333333,A+
662146,1012958,98,90,97,285,95.0,A+
662275,769885,98,92,88,278,92.66666666666667,A+
662681,76467,100,79,96,275,91.66666666666667,A+
662755,321611,87,98,94,279,93.0,A+
662939,422323,91,93,92,276,92.0,A+
663245,642779,93,94,94,281,93.66666666666667,A+
663432,248480,98,94,82,274,91.33333333333333,A+
663680,786357,80,98,97,275,91.66666666666667,A+
663687,530517,98,98,83,279,93.0,A+
663978,760183,98,94,99,291,97.0,A+
664009,962229,98,85,90,273,91.0,A+
664100,438899,90,88,97,275,91.66666666666667,A+
664230,746829,87,84,99,270,90.0,A+
664417,135583,94,97,82,273,91.0,A+
664435,808172,94,86,96,276,92.0,A+
664502,50011,79,99,99,277,92.33333333333333,A+
664555,307152,94,86,100,280,93.33333333333333,A+
664683,105368,98,77,99,274,91.33333333333333,A+
664929,850878,96,96,84,276,92.0,A+
664940,269177,96,91,99,286,95.33333333333333,A+
665023,773725,90,97,90,277,92.33333333333333,A+
665024,343769,77,95,100,272,90.66666666666667,A+
665599,136097,84,95,95,274,91.33333333333333,A+
665828,446927,74,97,100,271,90.33333333333333,A+
665981,859494,94,91,100,285,95.0,A+
666654,141887,90,86,95,271,90.33333333333333,A+
666757,315711,87,97,89,273,91.0,A+
666823,704953,92,96,90,278,92.66666666666667,A+
667344,873006,94,93,94,281,93.66666666666667,A+
667436,923717,98,78,100,276,92.0,A+
667490,36181,85,88,97,270,90.0,A+
667682,772080,97,89,90,276,92.0,A+
667735,927354,99,84,94,277,92.33333333333333,A+
668118,617460,100,81,90,271,90.33333333333333,A+
668188,710848,83,97,97,277,92.33333333333333,A+
668420,142425,93,97,84,274,91.33333333333333,A+
668509,551300,100,74,100,274,91.33333333333333,A+
668750,230614,100,100,79,279,93.0,A+
668759,606394,92,86,98,276,92.0,A+
669079,905966,94,98,80,272,90.66666666666667,A+
669080,87845,91,83,99,273,91.0,A+
669543,482676,96,84,98,278,92.66666666666667,A+
669816,922890,92,93,86,271,90.33333333333333,A+
670033,792397,96,89,92,277,92.33333333333333,A+
670237,169969,93,98,82,273,91.0,A+
670680,127513,85,97,93,275,91.66666666666667,A+
670810,735910,89,90,99,278,92.66666666666667,A+
670920,785347,97,90,86,273,91.0,A+
671150,347156,84,91,95,270,90.0,A+
671170,398722,100,86,92,278,92.66666666666667,A+
671800,187511,96,79,97,272,90.66666666666667,A+
671961,918966,97,76,97,270,90.0,A+
672123,1032192,89,95,87,271,90.33333333333333,A+
672225,723974,98,87,92,277,92.33333333333333,A+
672455,23066,88,97,96,281,93.66666666666667,A+
672536,331101,86,93,99,278,92.66666666666667,A+
673563,146827,94,100,87,281,93.66666666666667,A+
673598,527785,96,90,92,278,92.66666666666667,A+
673800,432968,98,86,96,280,93.33333333333333,A+
673814,705864,100,94,91,285,95.0,A+
674416,865168,98,73,99,270,90.0,A+
674437,372511,94,95,88,277,92.33333333333333,A+
674592,620359,77,98,99,274,91.33333333333333,A+
675295,834671,79,99,99,277,92.33333333333333,A+
675364,898098,92,87,93,272,90.66666666666667,A+
675726,604346,87,100,94,281,93.66666666666667,A+
675798,59989,93,83,95,271,90.33333333333333,A+
675803,91831,93,88,94,275,91.66666666666667,A+
675856,944914,91,90,93,274,91.33333333333333,A+
675920,299942,98,100,83,281,93.66666666666667,A+
676198,114698,100,84,94,278,92.66666666666667,A+
676280,704495,98,87,86,271,90.33333333333333,A+
676333,40974,95,92,90,277,92.33333333333333,A+
676728,850298,99,74,99,272,90.66666666666667,A+
676782,417780,91,89,93,273,91.0,A+
676860,960310,98,85,100,283,94.33333333333333,A+
676891,379867,99,82,98,279,93.0,A+
677622,467775,98,88,84,270,90.0,A+
677702,820015,88,99,100,287,95.66666666666667,A+
677754,215280,99,93,78,270,90.0,A+
677819,931652,100,88,95,283,94.33333333333333,A+
678010,606144,99,76,97,272,90.66666666666667,A+
678606,717726,83,98,93,274,91.33333333333333,A+
678850,48611,86,90,97,273,91.0,A+
678861,925355,97,76,97,270,90.0,A+
678972,24330,98,98,76,272,90.66666666666667,A+
679194,774594,89,94,100,283,94.33333333333333,A+
679446,308521,88,98,88,274,91.33333333333333,A+
679603,370560,95,98,84,277,92.33333333333333,A+
679668,463171,99,92,97,288,96.0,A+
679766,401517,92,92,94,278,92.66666666666667,A+
679898,225406,99,95,95,289,96.33333333333333,A+
679977,966075,84,100,93,277,92.33333333333333,A+
680002,910730,98,78,95,271,90.33333333333333,A+
680089,596722,100,79,100,279,93.0,A+
680225,71739,97,100,74,271,90.33333333333333,A+
680316,1004269,99,94,93,286,95.33333333333333,A+
680641,95989,93,91,98,282,94.0,A+
680652,234375,98,93,91,282,94.0,A+
680717,115744,84,93,99,276,92.0,A+
680736,20168,96,91,92,279,93.0,A+
680863,376491,86,100,85,271,90.33333333333333,A+
681559,231643,96,85,100,281,93.66666666666667,A+
681662,924609,94,99,91,284,94.66666666666667,A+
681781,282090,88,94,98,280,93.33333333333333,A+
681784,181415,84,100,93,277,92.33333333333333,A+
681882,52554,93,84,95,272,90.66666666666667,A+
681970,141930,100,87,86,273,91.0,A+
681996,361579,93,90,90,273,91.0,A+
682119,577749,97,98,91,286,95.33333333333333,A+
682196,786809,96,87,94,277,92.33333333333333,A+
682538,847199,85,90,99,274,91.33333333333333,A+
682540,142773,93,97,84,274,91.33333333333333,A+
682550,855330,84,88,99,271,90.33333333333333,A+
682741,836774,96,95,93,284,94.66666666666667,A+
682795,320676,97,98,93,288,96.0,A+
682823,676321,99,85,96,280,93.33333333333333,A+
682826,43273,79,98,99,276,92.0,A+
683035,401755,98,82,90,270,90.0,A+
683207,1009081,82,99,89,270,90.0,A+
683256,407411,98,82,96,276,92.0,A+
683279,684698,83,94,99,276,92.0,A+
683334,146192,85,100,98,283,94.33333333333333,A+
683387,523457,89,96,100,285,95.0,A+
683569,3580,80,97,93,270,90.0,A+
683653,768351,98,93,93,284,94.66666666666667,A+
683765,474342,91,97,96,284,94.66666666666667,A+
683934,701847,100,91,82,273,91.0,A+
684054,257481,81,100,97,278,92.66666666666667,A+
684084,476775,81,94,99,274,91.33333333333333,A+
684218,6900,96,89,96,281,93.66666666666667,A+
684331,717316,92,100,82,274,91.33333333333333,A+
684400,458176,99,89,97,285,95.0,A+
684703,386843,90,82,99,271,90.33333333333333,A+
684870,1005039,99,95,80,274,91.33333333333333,A+
685026,843004,100,75,95,270,90.0,A+
685161,400575,92,93,96,281,93.66666666666667,A+
685211,288675,100,73,97,270,90.0,A+
685709,829271,97,97,85,279,93.0,A+
686066,817001,78,94,100,272,90.66666666666667,A+
686191,92160,96,100,78,274,91.33333333333333,A+
686427,92815,86,98,87,271,90.33333333333333,A+
686598,763435,100,99,100,299,99.66666666666667,A+
686600,121576,100,85,90,275,91.66666666666667,A+
686617,359690,84,92,97,273,91.0,A+
687089,684183,93,97,86,276,92.0,A+
687347,643268,93,95,90,278,92.66666666666667,A+
687685,30683,97,98,83,278,92.66666666666667,A+
687976,41494,95,89,100,284,94.66666666666667,A+
688037,626993,77,98,97,272,90.66666666666667,A+
688076,113047,98,76,97,271,90.33333333333333,A+
688248,707467,99,91,95,285,95.0,A+
688465,811981,95,89,100,284,94.66666666666667,A+
688476,560068,78,94,98,270,90.0,A+
688554,829303,96,95,99,290,96.66666666666667,A+
688839,327194,79,100,95,274,91.33333333333333,A+
688866,477484,99,92,93,284,94.66666666666667,A+
689120,934275,93,96,86,275,91.66666666666667,A+
689552,78539,87,99,85,271,90.33333333333333,A+
690121,114454,100,84,96,280,93.33333333333333,A+
691041,1024030,99,96,91,286,95.33333333333333,A+
691147,465886,89,90,91,270,90.0,A+
691159,132851,76,100,97,273,91.0,A+
691182,147560,94,100,80,274,91.33333333333333,A+
691243,69172,100,80,92,272,90.66666666666667,A+
691349,510464,95,85,94,274,91.33333333333333,A+
692215,448645,91,93,100,284,94.66666666666667,A+
692410,324852,86,93,95,274,91.33333333333333,A+
692430,995710,82,98,91,271,90.33333333333333,A+
692542,692169,83,95,93,271,90.33333333333333,A+
692662,762554,98,92,91,281,93.66666666666667,A+
692826,930949,91,89,98,278,92.66666666666667,A+
692975,1018088,89,94,96,279,93.0,A+
693108,453420,89,87,97,273,91.0,A+
693260,654891,100,88,86,274,91.33333333333333,A+
693273,875690,93,89,92,274,91.33333333333333,A+
693677,933193,93,97,92,282,94.0,A+
694009,243448,97,90,88,275,91.66666666666667,A+
694254,634408,95,100,76,271,90.33333333333333,A+
694297,264426,96,89,96,281,93.66666666666667,A+
695324,158688,92,94,84,270,90.0,A+
695735,1039040,98,95,87,280,93.33333333333333,A+
695937,185713,100,93,89,282,94.0,A+
696057,511864,89,93,96,278,92.66666666666667,A+
696090,394082,93,93,94,280,93.33333333333333,A+
696505,77525,87,98,100,285,95.0,A+
696563,280836,88,96,94,278,92.66666666666667,A+
696873,245723,98,95,97,290,96.66666666666667,A+
696895,995429,97,86,94,277,92.33333333333333,A+
697220,257793,96,88,98,282,94.0,A+
697392,383260,85,98,100,283,94.33333333333333,A+
697399,244073,96,87,100,283,94.33333333333333,A+
697426,326008,94,90,94,278,92.66666666666667,A+
697823,552431,88,96,92,276,92.0,A+
698234,420336,92,95,94,281,93.66666666666667,A+
698801,551220,98,99,79,276,92.0,A+
698807,903552,86,99,98,283,94.33333333333333,A+
699192,289255,97,96,82,275,91.66666666666667,A+
699245,349094,96,100,81,277,92.33333333333333,A+
699351,448755,100,92,99,291,97.0,A+
699398,495820,100,99,77,276,92.0,A+
699523,516277,99,100,75,274,91.33333333333333,A+
699863,435731,92,95,84,271,90.33333333333333,A+
700010,460627,92,100,78,270,90.0,A+
700111,575126,96,94,82,272,90.66666666666667,A+
700184,458525,98,89,97,284,94.66666666666667,A+
700203,992995,92,100,97,289,96.33333333333333,A+
700303,998914,96,81,93,270,90.0,A+
700551,624981,95,99,99,293,97.66666666666667,A+
700690,1037011,89,96,98,283,94.33333333333333,A+
700746,777705,97,92,82,271,90.33333333333333,A+
700986,250156,90,100,97,287,95.66666666666667,A+
701644,999206,99,93,84,276,92.0,A+
701700,160505,84,100,94,278,92.66666666666667,A+
701981,532400,98,96,78,272,90.66666666666667,A+
701983,660755,100,87,97,284,94.66666666666667,A+
701992,522546,80,98,99,277,92.33333333333333,A+
702241,297883,98,100,98,296,98.66666666666667,A+
702868,655093,76,98,98,272,90.66666666666667,A+
703278,1000076,82,100,100,282,94.0,A+
703351,924156,94,100,89,283,94.33333333333333,A+
703399,540759,93,81,97,271,90.33333333333333,A+
703414,636634,93,94,92,279,93.0,A+
703540,811559,87,92,95,274,91.33333333333333,A+
703543,431849,90,89,91,270,90.0,A+
703568,814438,98,100,79,277,92.33333333333333,A+
703708,528348,89,99,98,286,95.33333333333333,A+
703750,169884,89,86,95,270,90.0,A+
703879,19110,94,83,93,270,90.0,A+
704200,734307,90,93,96,279,93.0,A+
704230,106114,86,97,98,281,93.66666666666667,A+
704246,819134,87,92,91,270,90.0,A+
704580,20797,96,92,84,272,90.66666666666667,A+
704720,603086,94,93,88,275,91.66666666666667,A+
704783,889306,93,91,88,272,90.66666666666667,A+
704890,47888,96,94,80,270,90.0,A+
704986,384030,85,99,87,271,90.33333333333333,A+
705106,858583,86,93,99,278,92.66666666666667,A+
705736,157252,83,95,93,271,90.33333333333333,A+
705845,145354,100,89,97,286,95.33333333333333,A+
706166,1016662,91,99,82,272,90.66666666666667,A+
706256,881070,94,93,86,273,91.0,A+
706609,187804,99,90,88,277,92.33333333333333,A+
706665,757247,98,91,84,273,91.0,A+
706676,700,99,100,85,284,94.66666666666667,A+
706885,823947,93,82,99,274,91.33333333333333,A+
707360,565063,79,97,99,275,91.66666666666667,A+
707374,753548,90,97,84,271,90.33333333333333,A+
707503,138708,98,79,100,277,92.33333333333333,A+
707505,425300,94,100,80,274,91.33333333333333,A+
707937,773694,98,96,93,287,95.66666666666667,A+
708031,945373,84,99,98,281,93.66666666666667,A+
708803,369753,86,100,85,271,90.33333333333333,A+
708883,843958,87,95,98,280,93.33333333333333,A+
709220,438599,93,99,91,283,94.33333333333333,A+
709467,1035054,81,100,97,278,92.66666666666667,A+
709477,946668,93,97,92,282,94.0,A+
709574,923863,91,89,98,278,92.66666666666667,A+
709915,341867,96,99,85,280,93.33333333333333,A+
709971,1015642,97,87,94,278,92.66666666666667,A+
710192,265404,81,99,93,273,91.0,A+
710278,219604,90,94,96,280,93.33333333333333,A+
710287,1009650,100,97,87,284,94.66666666666667,A+
710327,862416,100,78,93,271,90.33333333333333,A+
711189,497624,90,95,88,273,91.0,A+
711199,436563,90,91,100,281,93.66666666666667,A+
711256,260513,95,86,89,270,90.0,A+
711302,590099,95,92,84,271,90.33333333333333,A+
711375,536406,80,99,93,272,90.66666666666667,A+
711439,907386,84,94,97,275,91.66666666666667,A+
711718,755077,89,92,100,281,93.66666666666667,A+
711720,869649,78,99,97,274,91.33333333333333,A+
711933,828574,97,98,85,280,93.33333333333333,A+
712053,188110,90,89,97,276,92.0,A+
712305,841023,94,88,100,282,94.0,A+
712432,551672,98,98,81,277,92.33333333333333,A+
713130,898422,94,95,99,288,96.0,A+
713504,1013447,98,91,92,281,93.66666666666667,A+
713928,749635,98,90,94,282,94.0,A+
714107,780353,81,98,91,270,90.0,A+
714792,706770,100,91,95,286,95.33333333333333,A+
715070,147273,100,89,86,275,91.66666666666667,A+
715848,562844,97,99,97,293,97.66666666666667,A+
716106,517801,89,95,94,278,92.66666666666667,A+
716185,168642,93,98,90,281,93.66666666666667,A+
716328,461490,82,97,91,270,90.0,A+
716684,321091,88,100,84,272,90.66666666666667,A+
717196,35043,89,100,94,283,94.33333333333333,A+
717340,185536,99,91,99,289,96.33333333333333,A+
717512,648356,76,97,98,271,90.33333333333333,A+
717521,984165,100,96,74,270,90.0,A+
717657,19551,99,100,100,299,99.66666666666667,A+
717660,813412,95,89,94,278,92.66666666666667,A+
717767,626601,98,77,95,270,90.0,A+
718113,492923,100,99,96,295,98.33333333333333,A+
718809,163366,92,94,98,284,94.66666666666667,A+
718953,286975,79,97,99,275,91.66666666666667,A+
718989,509815,99,97,87,283,94.33333333333333,A+
719246,340186,87,100,96,283,94.33333333333333,A+
719675,508349,99,96,100,295,98.33333333333333,A+
720087,404611,97,76,97,270,90.0,A+
720293,255249,97,92,97,286,95.33333333333333,A+
720348,583980,100,78,94,272,90.66666666666667,A+
720351,270191,97,93,84,274,91.33333333333333,A+
720352,988067,83,100,87,270,90.0,A+
720591,1029014,81,99,97,277,92.33333333333333,A+
721219,926241,100,87,86,273,91.0,A+
721514,897938,95,99,82,276,92.0,A+
721822,367063,94,93,86,273,91.0,A+
722040,181451,99,91,82,272,90.66666666666667,A+
722164,190244,83,97,93,273,91.0,A+
722233,41629,86,90,99,275,91.66666666666667,A+
722280,125942,100,87,99,286,95.33333333333333,A+
722691,1007645,73,100,98,271,90.33333333333333,A+
723032,585729,93,86,96,275,91.66666666666667,A+
723739,653259,95,100,91,286,95.33333333333333,A+
724889,953058,93,98,92,283,94.33333333333333,A+
725206,279589,98,98,87,283,94.33333333333333,A+
725356,700729,99,90,95,284,94.66666666666667,A+
725527,477687,89,91,100,280,93.33333333333333,A+
725680,405668,99,85,96,280,93.33333333333333,A+
725704,192164,90,92,100,282,94.0,A+
725775,694266,91,91,89,271,90.33333333333333,A+
726061,425777,99,86,94,279,93.0,A+
726262,668574,100,87,90,277,92.33333333333333,A+
726373,461325,100,95,95,290,96.66666666666667,A+
726461,1043498,96,86,98,280,93.33333333333333,A+
726487,413843,92,95,92,279,93.0,A+
726633,25824,96,92,99,287,95.66666666666667,A+
726896,171425,82,95,93,270,90.0,A+
726932,153174,100,89,91,280,93.33333333333333,A+
726976,472697,98,88,96,282,94.0,A+
727421,765030,97,90,84,271,90.33333333333333,A+
727687,202998,100,97,94,291,97.0,A+
727717,620769,98,74,99,271,90.33333333333333,A+
727878,280176,89,98,88,275,91.66666666666667,A+
727950,1008250,91,99,90,280,93.33333333333333,A+
728132,37373,79,98,95,272,90.66666666666667,A+
728152,1009216,96,85,100,281,93.66666666666667,A+
728366,702508,84,100,93,277,92.33333333333333,A+
728743,169480,93,98,86,277,92.33333333333333,A+
728851,322198,78,98,94,270,90.0,A+
729142,773890,95,85,98,278,92.66666666666667,A+
729362,749011,99,93,82,274,91.33333333333333,A+
729695,967671,89,87,95,271,90.33333333333333,A+
729757,466552,98,88,94,280,93.33333333333333,A+
729859,293853,79,98,95,272,90.66666666666667,A+
729970,10434,98,96,89,283,94.33333333333333,A+
730018,814536,89,100,84,273,91.0,A+
730114,118935,95,100,89,284,94.66666666666667,A+
730133,612472,77,99,97,273,91.0,A+
730319,45302,87,97,87,271,90.33333333333333,A+
730558,774129,86,85,99,270,90.0,A+
731065,834628,100,77,98,275,91.66666666666667,A+
731144,778567,87,89,95,271,90.33333333333333,A+
731165,321233,96,97,97,290,96.66666666666667,A+
731344,484430,98,91,97,286,95.33333333333333,A+
731409,782345,89,96,85,270,90.0,A+
731579,144229,83,93,95,271,90.33333333333333,A+
731892,136452,93,94,92,279,93.0,A+
732127,465231,99,92,82,273,91.0,A+
732309,496640,96,85,94,275,91.66666666666667,A+
732491,101686,95,97,78,270,90.0,A+
732899,85100,86,98,96,280,93.33333333333333,A+
733145,420262,84,97,89,270,90.0,A+
733327,889490,95,98,97,290,96.66666666666667,A+
733351,857127,96,97,89,282,94.0,A+
733486,918636,93,96,99,288,96.0,A+
733855,414491,89,83,99,271,90.33333333333333,A+
734075,560673,96,93,90,279,93.0,A+
734428,494940,91,98,90,279,93.0,A+
734464,1003805,97,85,92,274,91.33333333333333,A+
734547,202075,89,90,93,272,90.66666666666667,A+
734681,330758,95,93,96,284,94.66666666666667,A+
734780,988457,92,100,78,270,90.0,A+
735159,752992,99,95,97,291,97.0,A+
735274,815295,95,87,89,271,90.33333333333333,A+
735332,744230,91,100,88,279,93.0,A+
735964,814396,89,99,88,276,92.0,A+
736370,672017,89,82,99,270,90.0,A+
736925,925752,100,87,90,277,92.33333333333333,A+
737080,878630,95,96,86,277,92.33333333333333,A+
737165,851943,92,82,99,273,91.0,A+
737611,951413,84,100,98,282,94.0,A+
737706,967542,92,96,98,286,95.33333333333333,A+
738101,713642,91,93,94,278,92.66666666666667,A+
738398,876467,95,97,99,291,97.0,A+
739314,155754,99,87,86,272,90.66666666666667,A+
739357,583888,88,99,96,283,94.33333333333333,A+
739397,972922,92,99,93,284,94.66666666666667,A+
739974,1002515,81,97,99,277,92.33333333333333,A+
740128,509767,80,96,99,275,91.66666666666667,A+
740249,598690,87,100,88,275,91.66666666666667,A+
740628,219022,100,98,75,273,91.0,A+
740664,58503,96,96,93,285,95.0,A+
740745,271793,96,90,88,274,91.33333333333333,A+
740843,64880,93,87,93,273,91.0,A+
741649,760457,90,95,94,279,93.0,A+
741746,296482,97,96,78,271,90.33333333333333,A+
741849,983494,91,95,92,278,92.66666666666667,A+
741960,992891,92,100,95,287,95.66666666666667,A+
742837,933841,90,85,99,274,91.33333333333333,A+
743188,104622,95,99,93,287,95.66666666666667,A+
743287,293309,98,99,85,282,94.0,A+
743341,1028457,82,100,93,275,91.66666666666667,A+
743410,830825,78,94,100,272,90.66666666666667,A+
743496,1022043,99,98,93,290,96.66666666666667,A+
743619,334041,87,100,94,281,93.66666666666667,A+
743687,450846,99,89,99,287,95.66666666666667,A+
743745,623325,100,81,100,281,93.66666666666667,A+
743754,1046120,89,95,89,273,91.0,A+
744029,224245,81,97,99,277,92.33333333333333,A+
744054,515991,90,99,86,275,91.66666666666667,A+
744344,269061,94,82,97,273,91.0,A+
744506,55116,88,100,98,286,95.33333333333333,A+
744544,443435,81,92,99,272,90.66666666666667,A+
744626,114246,85,96,97,278,92.66666666666667,A+
744691,601796,95,94,90,279,93.0,A+
744855,911726,94,98,89,281,93.66666666666667,A+
745418,988336,88,87,97,272,90.66666666666667,A+
745946,204318,91,97,88,276,92.0,A+
746192,178799,100,91,99,290,96.66666666666667,A+
746272,958151,100,90,93,283,94.33333333333333,A+
746402,565704,97,97,85,279,93.0,A+
746488,127139,95,100,76,271,90.33333333333333,A+
746682,596276,94,90,100,284,94.66666666666667,A+
746910,952183,100,91,80,271,90.33333333333333,A+
747613,986324,99,91,82,272,90.66666666666667,A+
748055,527222,88,92,91,271,90.33333333333333,A+
748443,645011,93,92,90,275,91.66666666666667,A+
748649,242751,97,91,88,276,92.0,A+
748664,394571,93,93,90,276,92.0,A+
749267,189235,83,100,87,270,90.0,A+
749677,734197,96,83,91,270,90.0,A+
749790,415579,83,93,95,271,90.33333333333333,A+
749799,298188,96,92,84,272,90.66666666666667,A+
750213,627103,86,98,96,280,93.33333333333333,A+
750353,302762,96,93,97,286,95.33333333333333,A+
750573,866861,94,92,92,278,92.66666666666667,A+
750619,642523,91,84,97,272,90.66666666666667,A+
750765,882489,99,78,98,275,91.66666666666667,A+
750832,730584,100,97,96,293,97.66666666666667,A+
751303,241498,98,94,84,276,92.0,A+
751313,594086,96,97,78,271,90.33333333333333,A+
751421,308803,96,95,97,288,96.0,A+
751499,894649,93,93,88,274,91.33333333333333,A+
751729,723167,89,89,93,271,90.33333333333333,A+
751915,736900,92,100,90,282,94.0,A+
752222,161171,93,98,97,288,96.0,A+
752688,969884,100,93,93,286,95.33333333333333,A+
752770,812158,96,91,90,277,92.33333333333333,A+
752874,298011,95,91,94,280,93.33333333333333,A+
752982,175821,74,98,98,270,90.0,A+
753210,737004,92,99,92,283,94.33333333333333,A+
753361,530726,98,97,87,282,94.0,A+
753907,239365,90,96,94,280,93.33333333333333,A+
753947,826410,97,99,97,293,97.66666666666667,A+
754435,692701,100,91,97,288,96.0,A+
754656,823683,97,95,86,278,92.66666666666667,A+
754673,510232,98,95,95,288,96.0,A+
754874,914227,84,93,99,276,92.0,A+
755177,625751,96,100,87,283,94.33333333333333,A+
755409,467366,100,96,95,291,97.0,A+
755531,878037,95,97,88,280,93.33333333333333,A+
755547,232559,90,97,86,273,91.0,A+
755986,107092,86,98,89,273,91.0,A+
755992,498493,89,92,98,279,93.0,A+
756209,229240,82,100,100,282,94.0,A+
756246,615656,95,95,84,274,91.33333333333333,A+
756577,307231,88,99,90,277,92.33333333333333,A+
756620,750339,91,99,97,287,95.66666666666667,A+
756869,108351,94,95,90,279,93.0,A+
757260,501323,97,89,88,274,91.33333333333333,A+
757384,1041743,94,79,99,272,90.66666666666667,A+
757713,437046,97,80,93,270,90.0,A+
758715,425221,99,88,90,277,92.33333333333333,A+
758755,243260,94,79,99,272,90.66666666666667,A+
759064,61181,86,93,93,272,90.66666666666667,A+
759105,103069,99,81,96,276,92.0,A+
759507,745906,99,95,97,291,97.0,A+
759632,1032150,95,84,91,270,90.0,A+
760420,223175,100,97,100,297,99.0,A+
760431,791328,99,99,98,296,98.66666666666667,A+
760532,489241,97,86,88,271,90.33333333333333,A+
760813,515245,72,100,98,270,90.0,A+
761335,78949,77,98,96,271,90.33333333333333,A+
761601,97273,84,90,99,273,91.0,A+
761744,945898,84,100,87,271,90.33333333333333,A+
761758,425111,75,99,96,270,90.0,A+
761810,139216,94,99,97,290,96.66666666666667,A+
762083,800395,89,97,98,284,94.66666666666667,A+
762179,1023009,97,88,86,271,90.33333333333333,A+
762203,264463,81,100,95,276,92.0,A+
762277,431953,75,99,98,272,90.66666666666667,A+
762282,1036662,90,97,98,285,95.0,A+
762422,434851,98,84,92,274,91.33333333333333,A+
762802,287734,100,74,99,273,91.0,A+
762834,758543,91,100,84,275,91.66666666666667,A+
763242,11779,94,83,95,272,90.66666666666667,A+
763487,314935,93,85,100,278,92.66666666666667,A+
763569,1011203,96,83,98,277,92.33333333333333,A+
763773,296263,87,93,97,277,92.33333333333333,A+
763822,716852,98,86,98,282,94.0,A+
764025,648336,95,100,78,273,91.0,A+
764113,230854,99,96,97,292,97.33333333333333,A+
764134,1001121,82,99,99,280,93.33333333333333,A+
764816,10923,98,96,85,279,93.0,A+
765113,304020,96,95,80,271,90.33333333333333,A+
765148,461532,92,98,82,272,90.66666666666667,A+
765201,998473,99,92,91,282,94.0,A+
765235,817704,87,93,97,277,92.33333333333333,A+
765283,974867,98,86,94,278,92.66666666666667,A+
765726,8624,99,100,81,280,93.33333333333333,A+
765797,661421,85,100,87,272,90.66666666666667,A+
765878,426267,83,97,95,275,91.66666666666667,A+
765887,310269,96,95,84,275,91.66666666666667,A+
766002,569373,98,100,93,291,97.0,A+
766015,211013,97,86,92,275,91.66666666666667,A+
766080,318645,95,93,82,270,90.0,A+
766184,586126,96,97,89,282,94.0,A+
766361,854786,88,100,94,282,94.0,A+
766585,279344,98,98,89,285,95.0,A+
766592,18774,97,93,93,283,94.33333333333333,A+
766675,585074,87,99,92,278,92.66666666666667,A+
766729,201353,92,99,99,290,96.66666666666667,A+
767016,297106,96,93,90,279,93.0,A+
767030,715586,80,90,100,270,90.0,A+
767117,238392,91,100,82,273,91.0,A+
767462,376370,98,76,99,273,91.0,A+
767504,243442,88,91,91,270,90.0,A+
767597,135254,90,85,97,272,90.66666666666667,A+
767601,752319,97,87,92,276,92.0,A+
767878,391588,97,75,99,271,90.33333333333333,A+
768122,564672,100,75,98,273,91.0,A+
768642,116447,93,92,96,281,93.66666666666667,A+
768650,1039340,79,94,99,272,90.66666666666667,A+
768792,959196,99,88,92,279,93.0,A+
768834,370554,86,99,87,272,90.66666666666667,A+
769092,795644,88,95,96,279,93.0,A+
769187,216296,92,100,86,278,92.66666666666667,A+
769434,358186,92,85,93,270,90.0,A+
769891,848947,93,87,96,276,92.0,A+
769972,981439,92,99,86,277,92.33333333333333,A+
770016,715843,83,100,98,281,93.66666666666667,A+
770791,20204,96,92,86,274,91.33333333333333,A+
770980,728938,99,93,78,270,90.0,A+
771312,843480,97,98,78,273,91.0,A+
771704,158059,92,93,92,277,92.33333333333333,A+
772124,452000,99,91,80,270,90.0,A+
772413,19299,97,94,82,273,91.0,A+
772471,112093,95,100,87,282,94.0,A+
772838,427074,92,95,94,281,93.66666666666667,A+
772896,454471,82,96,99,277,92.33333333333333,A+
773269,482816,96,84,94,274,91.33333333333333,A+
773473,56895,88,99,92,279,93.0,A+
773499,647873,85,97,100,282,94.0,A+
773520,911690,94,97,95,286,95.33333333333333,A+
773888,933181,90,87,93,270,90.0,A+
774050,211337,91,99,80,270,90.0,A+
774185,484539,99,95,78,272,90.66666666666667,A+
774204,489290,100,98,81,279,93.0,A+
774507,690152,92,95,98,285,95.0,A+
774529,987040,95,78,97,270,90.0,A+
774740,407282,93,96,82,271,90.33333333333333,A+
774749,783220,97,92,93,282,94.0,A+
774888,465966,92,98,99,289,96.33333333333333,A+
774966,790386,99,100,100,299,99.66666666666667,A+
774978,129787,94,96,80,270,90.0,A+
775288,607691,86,95,97,278,92.66666666666667,A+
776002,1007162,82,100,100,282,94.0,A+
776585,1032817,88,92,100,280,93.33333333333333,A+
777147,638341,92,90,98,280,93.33333333333333,A+
777774,653308,98,78,97,273,91.0,A+
778005,730664,95,77,99,271,90.33333333333333,A+
778106,276336,97,93,86,276,92.0,A+
778610,473889,91,98,94,283,94.33333333333333,A+
778834,623575,93,91,100,284,94.66666666666667,A+
778871,942572,98,82,94,274,91.33333333333333,A+
779263,208225,98,90,92,280,93.33333333333333,A+
779292,440928,83,97,91,271,90.33333333333333,A+
779398,422708,92,93,86,271,90.33333333333333,A+
779662,840858,88,100,92,280,93.33333333333333,A+
780216,1021646,97,87,100,284,94.66666666666667,A+
781495,235825,94,79,99,272,90.66666666666667,A+
781675,252840,89,96,94,279,93.0,A+
781929,268895,88,94,89,271,90.33333333333333,A+
781945,752368,100,98,85,283,94.33333333333333,A+
782089,784969,90,100,94,284,94.66666666666667,A+
782350,163,96,89,96,281,93.66666666666667,A+
782991,710578,92,99,82,273,91.0,A+
783007,442139,88,83,99,270,90.0,A+
783201,147103,93,97,99,289,96.33333333333333,A+
783281,292820,98,99,89,286,95.33333333333333,A+
783740,21806,80,100,95,275,91.66666666666667,A+
783924,713287,82,94,97,273,91.0,A+
784209,160046,91,91,89,271,90.33333333333333,A+
784742,770185,79,91,100,270,90.0,A+
784922,329554,99,74,99,272,90.66666666666667,A+
784966,680607,97,79,97,273,91.0,A+
785016,788906,88,94,96,278,92.66666666666667,A+
785082,874259,93,90,98,281,93.66666666666667,A+
785255,410548,82,89,100,271,90.33333333333333,A+
785325,265130,89,98,98,285,95.0,A+
785375,36431,79,99,97,275,91.66666666666667,A+
785888,877475,86,99,87,272,90.66666666666667,A+
785937,877145,98,76,97,271,90.33333333333333,A+
786030,845040,86,94,91,271,90.33333333333333,A+
786233,737340,89,89,93,271,90.33333333333333,A+
786576,943930,97,79,100,276,92.0,A+
786762,265961,80,98,97,275,91.66666666666667,A+
786858,57207,87,98,98,283,94.33333333333333,A+
786906,24606,97,95,89,281,93.66666666666667,A+
786907,807126,95,87,96,278,92.66666666666667,A+
786986,551135,95,87,92,274,91.33333333333333,A+
787012,177117,83,96,93,272,90.66666666666667,A+
787257,953468,99,86,98,283,94.33333333333333,A+
787332,326913,94,88,98,280,93.33333333333333,A+
787340,495747,99,97,89,285,95.0,A+
787662,121790,93,94,96,283,94.33333333333333,A+
788050,69912,94,91,88,273,91.0,A+
788213,468582,91,97,88,276,92.0,A+
788290,525626,98,95,84,277,92.33333333333333,A+
788990,22822,88,97,98,283,94.33333333333333,A+
789449,717653,97,85,100,282,94.0,A+
789503,656353,84,95,99,278,92.66666666666667,A+
789775,449690,90,92,100,282,94.0,A+
789826,1022490,90,97,98,285,95.0,A+
790061,169682,99,86,88,273,91.0,A+
790434,1011080,99,96,81,276,92.0,A+
790453,456562,97,82,94,273,91.0,A+
790666,957900,90,90,98,278,92.66666666666667,A+
790750,14684,95,88,96,279,93.0,A+
790877,829284,100,74,97,271,90.33333333333333,A+
791245,957979,100,92,82,274,91.33333333333333,A+
791418,121264,85,97,89,271,90.33333333333333,A+
792062,620261,86,98,94,278,92.66666666666667,A+
792264,548836,96,91,88,275,91.66666666666667,A+
792379,71037,96,97,95,288,96.0,A+
792484,214443,99,93,82,274,91.33333333333333,A+
792923,78991,87,98,87,272,90.66666666666667,A+
793079,344613,86,95,93,274,91.33333333333333,A+
793274,143636,83,94,97,274,91.33333333333333,A+
793509,754417,89,94,94,277,92.33333333333333,A+
794030,29205,95,87,96,278,92.66666666666667,A+
794356,712003,91,95,96,282,94.0,A+
794358,556479,95,89,92,276,92.0,A+
794603,766352,96,86,96,278,92.66666666666667,A+
794752,565173,87,96,98,281,93.66666666666667,A+
794927,701420,90,90,98,278,92.66666666666667,A+
795083,404030,100,87,99,286,95.33333333333333,A+
795157,351320,94,94,96,284,94.66666666666667,A+
795292,427624,98,83,96,277,92.33333333333333,A+
795450,574204,93,82,99,274,91.33333333333333,A+
795461,498731,95,82,93,270,90.0,A+
795718,499392,94,80,99,273,91.0,A+
796058,654250,82,88,100,270,90.0,A+
796394,985658,99,90,97,286,95.33333333333333,A+
796433,728553,99,92,84,275,91.66666666666667,A+
796487,197538,97,86,92,275,91.66666666666667,A+
796510,861475,100,78,96,274,91.33333333333333,A+
796598,309915,87,96,87,270,90.0,A+
796658,169578,99,87,86,272,90.66666666666667,A+
796722,618909,96,100,85,281,93.66666666666667,A+
796849,1009699,87,86,99,272,90.66666666666667,A+
796988,976922,97,82,100,279,93.0,A+
797212,511552,89,95,89,273,91.0,A+
797278,1004691,99,95,81,275,91.66666666666667,A+
797475,442255,91,92,100,283,94.33333333333333,A+
797608,1009129,100,100,77,277,92.33333333333333,A+
797875,620896,95,98,82,275,91.66666666666667,A+
797891,455705,100,95,83,278,92.66666666666667,A+
798231,840118,94,90,96,280,93.33333333333333,A+
798262,921698,99,83,88,270,90.0,A+
798301,276789,97,92,88,277,92.33333333333333,A+
798428,64892,96,97,93,286,95.33333333333333,A+
798511,1020876,88,90,95,273,91.0,A+
798924,504295,98,93,97,288,96.0,A+
799407,398276,94,97,92,283,94.33333333333333,A+
799410,336933,86,95,95,276,92.0,A+
799507,195031,99,91,84,274,91.33333333333333,A+
799627,332922,95,93,84,272,90.66666666666667,A+
799643,1024018,81,96,97,274,91.33333333333333,A+
800286,2144,86,87,97,270,90.0,A+
800287,716051,98,88,96,282,94.0,A+
800563,561608,87,93,91,271,90.33333333333333,A+
800652,988354,100,96,93,289,96.33333333333333,A+
800754,844649,77,94,100,271,90.33333333333333,A+
801305,55563,94,89,98,281,93.66666666666667,A+
801658,223792,82,98,97,277,92.33333333333333,A+
802004,659385,83,91,97,271,90.33333333333333,A+
802035,560324,96,94,90,280,93.33333333333333,A+
802050,531686,94,83,100,277,92.33333333333333,A+
802156,498425,89,94,89,272,90.66666666666667,A+
802243,492201,95,80,97,272,90.66666666666667,A+
802442,995116,98,88,88,274,91.33333333333333,A+
802852,462290,97,85,88,270,90.0,A+
802950,948723,92,93,98,283,94.33333333333333,A+
803036,1023259,90,98,86,274,91.33333333333333,A+
803238,77182,96,98,97,291,97.0,A+
803376,448124,91,96,90,277,92.33333333333333,A+
803457,885680,94,95,92,281,93.66666666666667,A+
803785,753365,96,85,92,273,91.0,A+
803844,389289,98,79,95,272,90.66666666666667,A+
804260,636426,94,95,88,277,92.33333333333333,A+
804774,219230,100,97,79,276,92.0,A+
804821,863028,96,97,93,286,95.33333333333333,A+
804902,317766,86,93,95,274,91.33333333333333,A+
805220,108407,91,83,99,273,91.0,A+
805227,725864,91,96,90,277,92.33333333333333,A+
805548,313437,94,88,98,280,93.33333333333333,A+
805664,399175,84,95,99,278,92.66666666666667,A+
805718,846892,95,91,90,276,92.0,A+
805746,112962,94,97,97,288,96.0,A+
805890,279,99,98,98,295,98.33333333333333,A+
806434,90193,93,90,96,279,93.0,A+
807059,508910,99,99,83,281,93.66666666666667,A+
807146,73819,86,94,97,277,92.33333333333333,A+
807889,129910,90,83,97,270,90.0,A+
808394,948368,98,83,96,277,92.33333333333333,A+
809227,558098,98,100,74,272,90.66666666666667,A+
809503,491859,89,91,100,280,93.33333333333333,A+
809779,805384,96,90,96,282,94.0,A+
809894,933021,94,99,82,275,91.66666666666667,A+
810052,505340,97,91,97,285,95.0,A+
810080,332843,85,91,99,275,91.66666666666667,A+
810170,701108,91,91,91,273,91.0,A+
810211,1010763,99,94,95,288,96.0,A+
810216,190286,92,98,84,274,91.33333333333333,A+
810267,306155,97,99,93,289,96.33333333333333,A+
810326,574669,95,91,100,286,95.33333333333333,A+
810362,684496,92,95,92,279,93.0,A+
810381,1046983,94,82,97,273,91.0,A+
810686,752961,100,97,83,280,93.33333333333333,A+
810803,512072,88,92,100,280,93.33333333333333,A+
811108,708518,93,99,97,289,96.33333333333333,A+
811118,326288,95,92,86,273,91.0,A+
811251,197893,91,95,94,280,93.33333333333333,A+
811389,950502,91,92,92,275,91.66666666666667,A+
811434,126327,85,98,98,281,93.66666666666667,A+
811480,419321,84,98,91,273,91.0,A+
811547,630203,100,81,96,277,92.33333333333333,A+
811699,904640,95,98,89,282,94.0,A+
811740,889276,86,100,96,282,94.0,A+
812087,603496,85,91,99,275,91.66666666666667,A+
812577,938378,82,89,100,271,90.33333333333333,A+
812628,1024305,90,97,86,273,91.0,A+
812953,92259,87,100,83,270,90.0,A+
813234,296966,96,92,94,282,94.0,A+
813525,612692,95,97,95,287,95.66666666666667,A+
813616,799484,80,100,97,277,92.33333333333333,A+
813674,862226,96,99,91,286,95.33333333333333,A+
813745,925251,82,88,100,270,90.0,A+
814109,97041,87,100,100,287,95.66666666666667,A+
814229,468992,97,84,94,275,91.66666666666667,A+
814642,811645,98,100,100,298,99.33333333333333,A+
814908,109562,99,81,98,278,92.66666666666667,A+
815106,605782,96,99,85,280,93.33333333333333,A+
815110,1041419,99,99,98,296,98.66666666666667,A+
815482,211472,90,95,96,281,93.66666666666667,A+
815597,82446,94,92,90,276,92.0,A+
815665,496188,81,96,97,274,91.33333333333333,A+
815898,776098,97,91,99,287,95.66666666666667,A+
815963,1021230,82,100,97,279,93.0,A+
815967,528775,99,100,83,282,94.0,A+
816066,635234,100,85,90,275,91.66666666666667,A+
816136,92424,93,88,91,272,90.66666666666667,A+
816148,80062,92,84,99,275,91.66666666666667,A+
816189,757266,94,78,99,271,90.33333333333333,A+
816725,410908,100,88,95,283,94.33333333333333,A+
817378,24845,88,96,89,273,91.0,A+
817509,2125,98,96,99,293,97.66666666666667,A+
817590,341819,78,99,97,274,91.33333333333333,A+
817861,116899,93,91,98,282,94.0,A+
817935,672378,92,91,98,281,93.66666666666667,A+
818261,805244,95,89,100,284,94.66666666666667,A+
818887,316378,96,95,93,284,94.66666666666667,A+
819495,110192,84,92,95,271,90.33333333333333,A+
819499,756484,91,100,99,290,96.66666666666667,A+
819748,397427,91,87,97,275,91.66666666666667,A+
819846,803219,88,94,91,273,91.0,A+
820192,713091,100,94,87,281,93.66666666666667,A+
820430,508862,81,98,95,274,91.33333333333333,A+
820588,670073,84,95,97,276,92.0,A+
820631,917486,94,98,97,289,96.33333333333333,A+
820683,622206,76,95,100,271,90.33333333333333,A+
820820,789297,98,95,87,280,93.33333333333333,A+
820982,907838,84,93,99,276,92.0,A+
821045,929769,100,89,99,288,96.0,A+
821146,149322,90,85,95,270,90.0,A+
821230,659752,94,100,93,287,95.66666666666667,A+
821233,64856,96,96,99,291,97.0,A+
821530,998785,98,91,97,286,95.33333333333333,A+
821555,20969,96,90,94,280,93.33333333333333,A+
821640,244672,90,97,100,287,95.66666666666667,A+
822453,980289,92,100,84,276,92.0,A+
822686,282615,88,95,87,270,90.0,A+
822833,872443,85,95,93,273,91.0,A+
822897,663615,100,86,84,270,90.0,A+
823044,544024,97,96,97,290,96.66666666666667,A+
823152,688928,100,89,86,275,91.66666666666667,A+
823555,143294,92,94,94,280,93.33333333333333,A+
823694,99418,95,98,89,282,94.0,A+
824016,194927,99,91,82,272,90.66666666666667,A+
824187,685089,92,94,90,276,92.0,A+
824425,663231,84,96,95,275,91.66666666666667,A+
824722,961147,98,85,96,279,93.0,A+
824785,983445,88,83,99,270,90.0,A+
825541,394883,92,91,96,279,93.0,A+
825727,577401,97,99,91,287,95.66666666666667,A+
825748,668917,75,98,98,271,90.33333333333333,A+
825813,490580,99,96,79,274,91.33333333333333,A+
825876,136862,99,82,98,279,93.0,A+
825925,545179,98,98,78,274,91.33333333333333,A+
826060,228615,98,93,82,273,91.0,A+
826067,563186,88,98,100,286,95.33333333333333,A+
826393,316714,77,95,98,270,90.0,A+
826509,299448,89,100,90,279,93.0,A+
826561,19605,87,93,91,271,90.33333333333333,A+
826621,966814,93,100,84,277,92.33333333333333,A+
826816,971865,90,91,93,274,91.33333333333333,A+
826872,842434,97,100,79,276,92.0,A+
826908,259712,80,98,93,271,90.33333333333333,A+
826913,421131,98,83,94,275,91.66666666666667,A+
826970,230982,97,87,94,278,92.66666666666667,A+
827275,238906,81,97,95,273,91.0,A+
827560,10874,95,85,91,271,90.33333333333333,A+
827599,366262,94,95,84,273,91.0,A+
827803,845810,95,91,96,282,94.0,A+
827972,935388,92,93,94,279,93.0,A+
828165,173479,81,91,98,270,90.0,A+
828444,964192,100,91,93,284,94.66666666666667,A+
828516,16615,98,98,85,281,93.66666666666667,A+
828625,70022,88,100,92,280,93.33333333333333,A+
828775,1009491,88,87,95,270,90.0,A+
828815,303202,93,82,99,274,91.33333333333333,A+
828871,362442,98,77,97,272,90.66666666666667,A+
829107,473088,92,99,92,283,94.33333333333333,A+
829134,955742,92,95,90,277,92.33333333333333,A+
829168,723320,92,100,88,280,93.33333333333333,A+
830156,627207,86,97,98,281,93.66666666666667,A+
830856,698112,92,96,88,276,92.0,A+
831012,856626,93,87,93,273,91.0,A+
831024,741436,99,93,87,279,93.0,A+
832271,459258,98,89,90,277,92.33333333333333,A+
832483,63548,100,77,100,277,92.33333333333333,A+
832664,557781,97,98,89,284,94.66666666666667,A+
833023,234369,89,93,94,276,92.0,A+
833670,4980,88,94,89,271,90.33333333333333,A+
833974,699194,100,92,99,291,97.0,A+
834033,934519,93,96,84,273,91.0,A+
834137,419278,90,86,95,271,90.33333333333333,A+
834313,1039113,99,97,74,270,90.0,A+
834712,812372,89,100,96,285,95.0,A+
834756,830372,93,84,93,270,90.0,A+
835041,286663,95,88,88,271,90.33333333333333,A+
835271,620505,86,98,91,275,91.66666666666667,A+
835552,605251,87,98,98,283,94.33333333333333,A+
835601,626810,98,76,99,273,91.0,A+
835710,662253,99,85,98,282,94.0,A+
835774,621281,95,99,76,270,90.0,A+
836010,195447,83,99,97,279,93.0,A+
836379,661323,94,100,82,276,92.0,A+
836477,866054,86,94,93,273,91.0,A+
836737,607697,95,95,95,285,95.0,A+
836801,218901,81,95,99,275,91.66666666666667,A+
836847,1002760,81,97,97,275,91.66666666666667,A+
836931,439393,99,88,90,277,92.33333333333333,A+
836978,885857,95,97,82,274,91.33333333333333,A+
837210,775878,79,93,100,272,90.66666666666667,A+
837465,542110,99,100,87,286,95.33333333333333,A+
837591,536754,80,99,93,272,90.66666666666667,A+
837654,871752,95,95,90,280,93.33333333333333,A+
837899,611090,96,100,91,287,95.66666666666667,A+
838432,343879,86,95,100,281,93.66666666666667,A+
838834,764229,98,91,82,271,90.33333333333333,A+
839013,939404,85,100,85,270,90.0,A+
839555,205670,97,84,92,273,91.0,A+
839603,448528,88,84,99,271,90.33333333333333,A+
840325,419743,92,95,96,283,94.33333333333333,A+
840367,716228,83,100,91,274,91.33333333333333,A+
840889,503316,90,97,88,275,91.66666666666667,A+
840909,942651,92,95,84,271,90.33333333333333,A+
841046,900684,84,95,91,270,90.0,A+
841261,410449,91,89,95,275,91.66666666666667,A+
842425,745588,90,97,94,281,93.66666666666667,A+
842497,515001,87,89,95,271,90.33333333333333,A+
842515,311382,95,92,92,279,93.0,A+
843112,327542,94,89,90,273,91.0,A+
843523,172446,100,91,93,284,94.66666666666667,A+
843533,146400,100,88,97,285,95.0,A+
843627,278984,80,100,95,275,91.66666666666667,A+
843774,508165,81,99,95,275,91.66666666666667,A+
843806,731263,88,86,99,273,91.0,A+
843905,488337,82,99,89,270,90.0,A+
844088,537287,97,95,97,289,96.33333333333333,A+
844118,173069,91,92,87,270,90.0,A+
844178,620603,92,87,91,270,90.0,A+
844388,247367,99,97,74,270,90.0,A+
844814,66274,77,95,98,270,90.0,A+
845030,951137,100,92,80,272,90.66666666666667,A+
845053,820510,97,98,93,288,96.0,A+
845060,782840,98,95,78,271,90.33333333333333,A+
845163,12072,97,94,86,277,92.33333333333333,A+
845238,289531,96,93,95,284,94.66666666666667,A+
845243,409893,91,90,91,272,90.66666666666667,A+
845475,939655,94,100,80,274,91.33333333333333,A+
846031,302902,96,94,93,283,94.33333333333333,A+
846226,515771,96,86,100,282,94.0,A+
846580,385284,85,97,91,273,91.0,A+
846976,321397,78,99,93,270,90.0,A+
847243,516890,80,97,93,270,90.0,A+
847271,110712,99,79,100,278,92.66666666666667,A+
848002,242367,97,91,94,282,94.0,A+
848158,828751,98,100,74,272,90.66666666666667,A+
848322,960450,98,86,96,280,93.33333333333333,A+
848444,355306,96,99,91,286,95.33333333333333,A+
848523,315626,99,74,97,270,90.0,A+
848629,56614,87,98,100,285,95.0,A+
848750,391936,97,74,99,270,90.0,A+
848782,961018,93,99,82,274,91.33333333333333,A+
848954,1028811,91,100,90,281,93.66666666666667,A+
848984,989632,97,85,92,274,91.33333333333333,A+
849233,327438,94,90,88,272,90.66666666666667,A+
849812,166998,100,90,91,281,93.66666666666667,A+
850080,174720,93,100,84,277,92.33333333333333,A+
850331,729459,98,90,88,276,92.0,A+
851262,916361,92,91,90,273,91.0,A+
851273,488685,82,99,89,270,90.0,A+
851332,1028384,96,88,100,284,94.66666666666667,A+
851424,766883,90,97,88,275,91.66666666666667,A+
851485,607280,95,97,86,278,92.66666666666667,A+
851586,486942,98,90,84,272,90.66666666666667,A+
851644,143954,92,92,100,284,94.66666666666667,A+
851839,891097,95,99,80,274,91.33333333333333,A+
851967,847137,95,91,88,274,91.33333333333333,A+
852267,480004,100,97,100,297,99.0,A+
852552,732539,100,98,79,277,92.33333333333333,A+
852691,227955,99,95,76,270,90.0,A+
853196,542759,80,99,99,278,92.66666666666667,A+
853404,576600,97,100,89,286,95.33333333333333,A+
853428,197024,92,99,84,275,91.66666666666667,A+
853506,911414,95,100,82,277,92.33333333333333,A+
853671,1030279,99,96,95,290,96.66666666666667,A+
854002,183402,98,87,86,271,90.33333333333333,A+
854289,519690,97,93,86,276,92.0,A+
854582,675618,90,86,99,275,91.66666666666667,A+
855189,455168,97,84,94,275,91.66666666666667,A+
855388,922500,83,93,95,271,90.33333333333333,A+
855410,974561,92,98,90,280,93.33333333333333,A+
856024,246873,98,93,99,290,96.66666666666667,A+
856134,944767,97,79,95,271,90.33333333333333,A+
857015,315681,96,96,93,285,95.0,A+
857055,830415,87,96,89,272,90.66666666666667,A+
857098,779173,90,99,92,281,93.66666666666667,A+
857224,77616,99,77,98,274,91.33333333333333,A+
857403,282205,98,97,76,271,90.33333333333333,A+
857536,772569,97,89,86,272,90.66666666666667,A+
857580,525089,95,83,95,273,91.0,A+
857987,308197,93,85,100,278,92.66666666666667,A+
858098,858473,77,94,100,271,90.33333333333333,A+
858142,531967,95,84,91,270,90.0,A+
858272,160896,94,100,84,278,92.66666666666667,A+
858344,909837,86,100,96,282,94.0,A+
858360,949554,98,83,92,273,91.0,A+
858552,48751,86,91,93,270,90.0,A+
858585,341574,78,99,99,276,92.0,A+
858776,821940,97,98,87,282,94.0,A+
858829,233116,90,96,90,276,92.0,A+
859246,755536,98,91,99,288,96.0,A+
859266,964222,91,93,90,274,91.33333333333333,A+
859292,218760,96,84,98,278,92.66666666666667,A+
859379,518852,97,93,91,281,93.66666666666667,A+
859557,739089,82,97,95,274,91.33333333333333,A+
859571,643568,90,83,97,270,90.0,A+
859677,869936,87,100,86,273,91.0,A+
859681,587019,93,85,93,271,90.33333333333333,A+
859711,488997,97,86,90,273,91.0,A+
859996,389924,92,90,89,271,90.33333333333333,A+
860310,494513,96,86,100,282,94.0,A+
860473,251996,96,87,96,279,93.0,A+
860586,264567,81,100,97,278,92.66666666666667,A+
860724,123912,84,93,93,270,90.0,A+
861552,261632,88,93,100,281,93.66666666666667,A+
861564,533550,97,94,80,271,90.33333333333333,A+
861593,204354,92,98,82,272,90.66666666666667,A+
861710,388738,92,90,94,276,92.0,A+
861900,701639,100,92,78,270,90.0,A+
862043,218735,91,97,86,274,91.33333333333333,A+
862153,542997,86,89,95,270,90.0,A+
863127,237903,91,99,86,276,92.0,A+
863260,723168,74,100,98,272,90.66666666666667,A+
863358,501421,88,89,93,270,90.0,A+
863514,555714,96,92,84,272,90.66666666666667,A+
863611,772289,81,98,99,278,92.66666666666667,A+
863948,900935,94,94,86,274,91.33333333333333,A+
864010,825237,93,81,97,271,90.33333333333333,A+
864529,497802,98,93,95,286,95.33333333333333,A+
865086,90473,94,91,88,273,91.0,A+
865148,941710,93,96,86,275,91.66666666666667,A+
865466,487988,97,89,84,270,90.0,A+
865897,288479,88,95,98,281,93.66666666666667,A+
865996,51655,87,96,94,277,92.33333333333333,A+
866464,147072,94,100,84,278,92.66666666666667,A+
866537,115848,99,82,96,277,92.33333333333333,A+
866565,899847,100,84,90,274,91.33333333333333,A+
866957,328600,96,98,89,283,94.33333333333333,A+
867500,898557,100,86,92,278,92.66666666666667,A+
867856,371,96,88,100,284,94.66666666666667,A+
867954,125618,98,79,93,270,90.0,A+
867968,740629,90,95,88,273,91.0,A+
868025,479924,82,99,97,278,92.66666666666667,A+
868458,8691,98,98,89,285,95.0,A+
868499,506606,99,99,100,298,99.33333333333333,A+
868595,156421,92,95,94,281,93.66666666666667,A+
868699,250639,81,100,95,276,92.0,A+
869190,1044207,98,95,97,290,96.66666666666667,A+
869278,339415,94,93,86,273,91.0,A+
869705,618861,77,100,97,274,91.33333333333333,A+
869711,690494,98,85,96,279,93.0,A+
869833,613621,92,87,93,272,90.66666666666667,A+
869968,547974,98,100,98,296,98.66666666666667,A+
870873,936262,92,94,84,270,90.0,A+
871079,460488,100,95,100,295,98.33333333333333,A+
871200,288583,87,94,100,281,93.66666666666667,A+
871388,26508,93,81,99,273,91.0,A+
871903,945263,75,100,99,274,91.33333333333333,A+
872816,1024960,80,95,95,270,90.0,A+
873405,507914,88,89,95,272,90.66666666666667,A+
873582,777424,97,91,90,278,92.66666666666667,A+
873678,1006782,99,92,80,271,90.33333333333333,A+
873842,14690,89,99,98,286,95.33333333333333,A+
873881,340290,87,100,98,285,95.0,A+
874077,641972,85,96,95,276,92.0,A+
874525,199121,100,95,81,276,92.0,A+
874537,587067,96,96,86,278,92.66666666666667,A+
874656,133248,94,100,85,279,93.0,A+
874701,580219,87,97,87,271,90.33333333333333,A+
874866,412833,93,97,86,276,92.0,A+
875029,442328,91,95,88,274,91.33333333333333,A+
875048,478322,99,92,88,279,93.0,A+
875138,268511,88,94,96,278,92.66666666666667,A+
875242,830587,87,94,100,281,93.66666666666667,A+
875532,992426,90,91,93,274,91.33333333333333,A+
875616,222251,88,89,99,276,92.0,A+
875699,480352,100,97,100,297,99.0,A+
875787,1036881,99,99,79,277,92.33333333333333,A+
875798,612184,99,77,98,274,91.33333333333333,A+
876060,782976,97,92,95,284,94.66666666666667,A+
876472,1043534,96,87,92,275,91.66666666666667,A+
876540,440054,98,85,96,279,93.0,A+
877197,583191,88,100,96,284,94.66666666666667,A+
877444,396033,92,89,98,279,93.0,A+
877597,821904,97,96,93,286,95.33333333333333,A+
877800,113102,94,97,93,284,94.66666666666667,A+
877891,536161,96,89,90,275,91.66666666666667,A+
878409,188813,83,98,99,280,93.33333333333333,A+
878458,337392,95,94,94,283,94.33333333333333,A+
878513,746259,100,98,77,275,91.66666666666667,A+
878759,754599,99,96,81,276,92.0,A+
879039,148637,93,96,94,283,94.33333333333333,A+
879083,454960,98,85,90,273,91.0,A+
879378,623091,94,95,84,273,91.0,A+
879443,375226,92,89,100,281,93.66666666666667,A+
879472,180193,99,89,99,287,95.66666666666667,A+
880355,774251,98,94,97,289,96.33333333333333,A+
880535,827278,89,100,90,279,93.0,A+
880539,296403,87,94,93,274,91.33333333333333,A+
880620,330049,92,84,97,273,91.0,A+
880668,471584,99,92,88,279,93.0,A+
880822,418539,96,76,99,271,90.33333333333333,A+
881004,53049,87,95,93,275,91.66666666666667,A+
881455,727564,81,93,99,273,91.0,A+
881648,463752,96,82,95,273,91.0,A+
881946,533826,96,91,92,279,93.0,A+
882056,42368,79,100,95,274,91.33333333333333,A+
882093,781129,98,95,93,286,95.33333333333333,A+
882505,742029,99,93,84,276,92.0,A+
882717,461776,92,98,80,270,90.0,A+
882848,119424,95,100,85,280,93.33333333333333,A+
883010,778714,81,100,93,274,91.33333333333333,A+
883214,1019586,89,92,98,279,93.0,A+
883243,333332,100,80,90,270,90.0,A+
883555,342515,93,87,91,271,90.33333333333333,A+
883570,1011777,99,95,80,274,91.33333333333333,A+
883735,407,96,89,94,279,93.0,A+
883923,411922,85,100,85,270,90.0,A+
883934,570651,94,89,92,275,91.66666666666667,A+
884014,771628,81,100,93,274,91.33333333333333,A+
884164,50933,97,100,77,274,91.33333333333333,A+
884330,389203,95,99,95,289,96.33333333333333,A+
884644,593450,87,97,89,273,91.0,A+
884970,751451,98,90,82,270,90.0,A+
884976,237976,99,97,91,287,95.66666666666667,A+
885042,1031661,95,84,96,275,91.66666666666667,A+
885114,1013519,98,93,80,271,90.33333333333333,A+
885128,543040,80,100,91,271,90.33333333333333,A+
885275,892858,91,84,95,270,90.0,A+
885523,427734,91,93,100,284,94.66666666666667,A+
885789,35985,88,99,92,279,93.0,A+
885801,1002491,99,95,99,293,97.66666666666667,A+
885948,297522,95,91,98,284,94.66666666666667,A+
886082,134043,85,99,89,273,91.0,A+
886163,376510,83,88,100,271,90.33333333333333,A+
886293,445080,74,100,98,272,90.66666666666667,A+
886341,243803,91,100,90,281,93.66666666666667,A+
886998,384421,95,100,78,273,91.0,A+
887044,639288,86,100,98,284,94.66666666666667,A+
887055,164442,83,94,95,272,90.66666666666667,A+
887222,812090,96,93,82,271,90.33333333333333,A+
887255,715218,100,92,80,272,90.66666666666667,A+
887273,125080,95,100,91,286,95.33333333333333,A+
887762,556943,97,98,93,288,96.0,A+
887830,221321,99,94,78,271,90.33333333333333,A+
887913,505407,89,94,87,270,90.0,A+
888034,213325,99,92,95,286,95.33333333333333,A+
888036,236815,97,89,90,276,92.0,A+
889134,987756,91,97,98,286,95.33333333333333,A+
889602,975558,88,85,97,270,90.0,A+
889837,908333,93,92,92,277,92.33333333333333,A+
890037,751042,100,98,94,292,97.33333333333333,A+
890105,549080,96,91,86,273,91.0,A+
890309,553043,100,72,99,271,90.33333333333333,A+
890949,892283,95,99,76,270,90.0,A+
891040,105600,95,100,85,280,93.33333333333333,A+
891217,1027405,88,92,91,271,90.33333333333333,A+
891394,327798,97,99,87,283,94.33333333333333,A+
891505,597248,85,91,95,271,90.33333333333333,A+
891625,100520,91,85,97,273,91.0,A+
891721,282829,97,94,88,279,93.0,A+
891749,28269,89,99,100,288,96.0,A+
891755,544648,88,97,92,277,92.33333333333333,A+
892101,859843,94,91,100,285,95.0,A+
892114,936287,98,81,96,275,91.66666666666667,A+
892295,1026213,95,82,93,270,90.0,A+
892303,117730,99,80,92,271,90.33333333333333,A+
892690,302132,88,97,87,272,90.66666666666667,A+
892885,774324,99,96,85,280,93.33333333333333,A+
893035,619864,99,77,95,271,90.33333333333333,A+
893103,620964,95,96,91,282,94.0,A+
893177,427416,83,95,97,275,91.66666666666667,A+
893208,451261,90,91,89,270,90.0,A+
893770,947848,83,97,91,271,90.33333333333333,A+
893811,642284,100,84,96,280,93.33333333333333,A+
893946,668184,91,87,99,277,92.33333333333333,A+
893949,866574,100,81,98,279,93.0,A+
893973,557176,79,99,97,275,91.66666666666667,A+
894079,413097,90,84,99,273,91.0,A+
894223,582170,86,93,91,270,90.0,A+
894431,663023,84,97,91,272,90.66666666666667,A+
894472,719016,98,86,86,270,90.0,A+
894790,656431,94,97,84,275,91.66666666666667,A+
894895,584084,100,78,96,274,91.33333333333333,A+
895016,238802,81,98,93,272,90.66666666666667,A+
895251,561718,96,92,90,278,92.66666666666667,A+
895356,459118,83,99,100,282,94.0,A+
895357,87399,85,94,99,278,92.66666666666667,A+
895421,406890,99,85,86,270,90.0,A+
896149,441344,98,84,94,276,92.0,A+
896507,611977,84,89,99,272,90.66666666666667,A+
897092,543804,79,97,99,275,91.66666666666667,A+
897140,1041211,99,100,94,293,97.66666666666667,A+
897180,174280,81,89,100,270,90.0,A+
897469,620010,92,87,93,272,90.66666666666667,A+
898311,290014,87,93,93,273,91.0,A+
898469,180369,99,91,89,279,93.0,A+
898591,771347,97,88,96,281,93.66666666666667,A+
898601,23836,89,98,84,271,90.33333333333333,A+
898694,233428,89,94,96,279,93.0,A+
898748,82898,94,91,92,277,92.33333333333333,A+
899036,402764,98,79,95,272,90.66666666666667,A+
899232,91776,96,100,85,281,93.66666666666667,A+
899399,223682,88,89,93,270,90.0,A+
899419,65167,87,98,87,272,90.66666666666667,A+
899636,793479,96,89,86,271,90.33333333333333,A+
899718,603923,94,92,84,270,90.0,A+
900341,464326,100,94,78,272,90.66666666666667,A+
900571,245399,96,87,92,275,91.66666666666667,A+
900798,932673,94,99,82,275,91.66666666666667,A+
901088,494659,90,97,98,285,95.0,A+
901126,50444,97,100,81,278,92.66666666666667,A+
901350,594465,95,94,92,281,93.66666666666667,A+
901603,452123,96,78,97,271,90.33333333333333,A+
902177,621931,100,82,100,282,94.0,A+
902594,570370,94,87,100,281,93.66666666666667,A+
902834,195686,74,99,98,271,90.33333333333333,A+
902855,695385,84,99,100,283,94.33333333333333,A+
903258,312422,86,91,95,272,90.66666666666667,A+
903414,485855,89,91,93,273,91.0,A+
903494,192976,100,95,78,273,91.0,A+
903968,233287,89,93,100,282,94.0,A+
903992,386023,94,97,82,273,91.0,A+
904019,610234,85,91,99,275,91.66666666666667,A+
904236,36437,88,98,94,280,93.33333333333333,A+
904459,41298,98,100,96,294,98.0,A+
904632,181935,98,87,98,283,94.33333333333333,A+
904763,338285,92,82,99,273,91.0,A+
904960,711997,97,84,94,275,91.66666666666667,A+
905026,669626,93,96,92,281,93.66666666666667,A+
905242,579890,99,74,97,270,90.0,A+
905303,913530,99,84,94,277,92.33333333333333,A+
905766,1033061,88,92,98,278,92.66666666666667,A+
905834,826515,97,98,100,295,98.33333333333333,A+
906040,198247,100,95,91,286,95.33333333333333,A+
906186,695025,81,89,100,270,90.0,A+
906201,843750,87,96,93,276,92.0,A+
906327,592570,93,86,98,277,92.33333333333333,A+
906513,591562,78,99,97,274,91.33333333333333,A+
906750,205541,99,93,95,287,95.66666666666667,A+
906761,645561,99,80,92,271,90.33333333333333,A+
906790,133798,100,88,86,274,91.33333333333333,A+
906973,766908,96,84,100,280,93.33333333333333,A+
907199,537213,89,97,92,278,92.66666666666667,A+
907298,213105,81,94,97,272,90.66666666666667,A+
907424,77952,96,99,85,280,93.33333333333333,A+
907577,232412,96,86,88,270,90.0,A+
907739,746071,97,87,88,272,90.66666666666667,A+
907807,547155,87,92,99,278,92.66666666666667,A+
907861,62300,94,89,98,281,93.66666666666667,A+
907971,830457,97,97,80,274,91.33333333333333,A+
908168,857439,95,95,95,285,95.0,A+
908172,752643,91,99,80,270,90.0,A+
908267,315216,94,87,91,272,90.66666666666667,A+
908382,746291,99,95,91,285,95.0,A+
909044,960835,83,97,95,275,91.66666666666667,A+
909163,774600,98,94,97,289,96.33333333333333,A+
909214,397463,76,99,96,271,90.33333333333333,A+
909303,202117,99,90,84,273,91.0,A+
909539,440971,100,93,99,292,97.33333333333333,A+
909581,435199,82,94,97,273,91.0,A+
909649,1046989,88,92,100,280,93.33333333333333,A+
909748,653919,94,98,97,289,96.33333333333333,A+
909942,300567,97,97,95,289,96.33333333333333,A+
910050,657196,93,94,92,279,93.0,A+
910222,48379,88,100,98,286,95.33333333333333,A+
910295,456819,99,92,91,282,94.0,A+
910352,430418,90,90,98,278,92.66666666666667,A+
910511,1044452,98,95,95,288,96.0,A+
910570,1036442,72,99,100,271,90.33333333333333,A+
910958,698736,91,93,100,284,94.66666666666667,A+
911094,645182,92,90,100,282,94.0,A+
911248,619882,95,97,97,289,96.33333333333333,A+
911346,197226,98,87,86,271,90.33333333333333,A+
911370,333797,87,100,96,283,94.33333333333333,A+
911384,810220,100,71,99,270,90.0,A+
911528,954617,98,84,100,282,94.0,A+
912083,206067,100,95,85,280,93.33333333333333,A+
912175,376204,92,89,91,272,90.66666666666667,A+
912412,197856,91,94,100,285,95.0,A+
912534,953712,99,86,96,281,93.66666666666667,A+
912551,488936,91,98,84,273,91.0,A+
912612,416527,91,91,89,271,90.33333333333333,A+
912701,691618,92,96,86,274,91.33333333333333,A+
913043,826062,98,99,98,295,98.33333333333333,A+
913361,340278,100,79,94,273,91.0,A+
913649,1041639,94,79,97,270,90.0,A+
913736,421932,98,82,96,276,92.0,A+
913945,973962,98,88,90,276,92.0,A+
914055,418422,94,99,84,277,92.33333333333333,A+
914299,809504,88,96,89,273,91.0,A+
914438,639819,95,100,85,280,93.33333333333333,A+
914525,947604,83,97,93,273,91.0,A+
914600,627898,92,86,95,273,91.0,A+
914627,613529,95,97,91,283,94.33333333333333,A+
914886,571000,94,88,92,274,91.33333333333333,A+
915141,645219,92,91,94,277,92.33333333333333,A+
915151,622358,94,95,90,279,93.0,A+
915274,557769,79,98,95,272,90.66666666666667,A+
915389,682570,99,85,100,284,94.66666666666667,A+
915442,872297,76,94,100,270,90.0,A+
915575,426573,89,85,99,273,91.0,A+
915616,64128,97,99,85,281,93.66666666666667,A+
915665,260806,98,97,81,276,92.0,A+
915722,671669,89,82,99,270,90.0,A+
916013,861585,93,88,100,281,93.66666666666667,A+
916414,817105,93,83,97,273,91.0,A+
916665,702612,83,99,95,277,92.33333333333333,A+
916688,495246,81,97,99,277,92.33333333333333,A+
916689,753413,99,96,85,280,93.33333333333333,A+
916723,477380,99,93,91,283,94.33333333333333,A+
916959,380783,93,94,84,271,90.33333333333333,A+
916960,656291,93,96,88,277,92.33333333333333,A+
917752,58803,93,84,99,276,92.0,A+
917797,251977,99,99,81,279,93.0,A+
918685,216217,97,88,96,281,93.66666666666667,A+
918700,1014908,97,87,100,284,94.66666666666667,A+
918739,155027,93,97,94,284,94.66666666666667,A+
918851,632929,92,90,89,271,90.33333333333333,A+
919127,217819,97,85,100,282,94.0,A+
919329,217243,100,99,81,280,93.33333333333333,A+
919544,562147,98,99,98,295,98.33333333333333,A+
919704,236821,91,100,92,283,94.33333333333333,A+
919808,682845,90,87,95,272,90.66666666666667,A+
919856,848556,100,76,100,276,92.0,A+
919991,585600,96,96,99,291,97.0,A+
920154,759302,97,87,90,274,91.33333333333333,A+
920456,762975,98,94,78,270,90.0,A+
920512,580281,78,95,98,271,90.33333333333333,A+
920567,824900,95,91,96,282,94.0,A+
920687,637760,95,100,99,294,98.0,A+
920797,956188,98,83,90,271,90.33333333333333,A+
920806,170978,92,95,88,275,91.66666666666667,A+
921319,905643,85,96,97,278,92.66666666666667,A+
921773,348410,99,78,93,270,90.0,A+
921926,668751,85,100,85,270,90.0,A+
922123,807713,86,87,97,270,90.0,A+
922459,1007406,82,100,97,279,93.0,A+
922505,597009,94,90,94,278,92.66666666666667,A+
922673,425564,75,98,98,271,90.33333333333333,A+
922851,80844,95,95,86,276,92.0,A+
923271,966325,93,100,88,281,93.66666666666667,A+
923808,50304,97,99,85,281,93.66666666666667,A+
923854,780286,89,96,100,285,95.0,A+
924204,361653,86,99,100,285,95.0,A+
924303,716338,92,99,90,281,93.66666666666667,A+
924431,437370,99,89,99,287,95.66666666666667,A+
924666,385944,100,84,92,276,92.0,A+
924876,440231,83,98,91,272,90.66666666666667,A+
924929,43481,94,87,98,279,93.0,A+
925161,564695,98,100,79,277,92.33333333333333,A+
925225,195483,83,100,91,274,91.33333333333333,A+
925379,288313,97,96,85,278,92.66666666666667,A+
925681,224984,91,97,90,278,92.66666666666667,A+
925719,1045974,79,95,97,271,90.33333333333333,A+
925824,343989,95,94,99,288,96.0,A+
925939,114949,94,94,94,282,94.0,A+
926236,312256,95,93,82,270,90.0,A+
926245,144473,99,83,88,270,90.0,A+
926334,641165,92,87,91,270,90.0,A+
926375,454728,100,95,91,286,95.33333333333333,A+
926413,556827,79,99,97,275,91.66666666666667,A+
927463,872235,86,96,89,271,90.33333333333333,A+
927615,786265,99,98,89,286,95.33333333333333,A+
928167,735799,95,80,95,270,90.0,A+
928390,1016339,81,97,99,277,92.33333333333333,A+
928562,643085,99,82,98,279,93.0,A+
928735,575823,95,93,82,270,90.0,A+
929110,576973,95,91,84,270,90.0,A+
929140,92492,92,86,100,278,92.66666666666667,A+
929400,149995,92,93,100,285,95.0,A+
929597,565698,88,97,87,272,90.66666666666667,A+
930437,212383,99,93,97,289,96.33333333333333,A+
930652,896356,92,89,94,275,91.66666666666667,A+
930744,556687,95,88,96,279,93.0,A+
930814,90437,78,100,99,277,92.33333333333333,A+
931288,649273,93,95,96,284,94.66666666666667,A+
931623,573647,78,94,100,272,90.66666666666667,A+
931663,592222,93,86,98,277,92.33333333333333,A+
931757,876393,86,99,94,279,93.0,A+
932000,36480,98,99,85,282,94.0,A+
932051,511698,98,95,82,275,91.66666666666667,A+
932200,371766,76,95,100,271,90.33333333333333,A+
932311,355539,77,100,95,272,90.66666666666667,A+
932574,192891,81,93,97,271,90.33333333333333,A+
932876,674475,100,88,95,283,94.33333333333333,A+
933069,121020,85,97,91,273,91.0,A+
933159,458800,90,90,91,271,90.33333333333333,A+
933193,18670,97,94,90,281,93.66666666666667,A+
933361,655032,85,99,87,271,90.33333333333333,A+
933564,448082,82,95,99,276,92.0,A+
933643,839537,97,100,98,295,98.33333333333333,A+
934063,938916,85,100,89,274,91.33333333333333,A+
934268,190702,91,96,92,279,93.0,A+
934288,521610,90,98,98,286,95.33333333333333,A+
934315,31436,79,96,96,271,90.33333333333333,A+
934434,734864,89,91,100,280,93.33333333333333,A+
934488,584225,85,89,97,271,90.33333333333333,A+
934669,295456,78,95,99,272,90.66666666666667,A+
934945,787818,95,84,100,279,93.0,A+
935084,381053,83,91,99,273,91.0,A+
935644,72956,96,97,84,277,92.33333333333333,A+
935789,752997,100,99,77,276,92.0,A+
935804,178382,100,93,91,284,94.66666666666667,A+
936144,1023566,81,97,95,273,91.0,A+
936176,520216,90,100,99,289,96.33333333333333,A+
936415,768559,98,92,97,287,95.66666666666667,A+
936628,192048,88,83,99,270,90.0,A+
936730,894753,93,92,90,275,91.66666666666667,A+
936736,177992,91,93,100,284,94.66666666666667,A+
936902,696919,99,87,90,276,92.0,A+
937009,129500,84,95,91,270,90.0,A+
937109,427520,98,84,94,276,92.0,A+
937554,379799,84,94,95,273,91.0,A+
937743,932282,100,88,86,274,91.33333333333333,A+
938052,253501,89,94,100,283,94.33333333333333,A+
938165,313730,97,99,89,285,95.0,A+
938434,312771,86,90,95,271,90.33333333333333,A+
938686,376705,95,99,87,281,93.66666666666667,A+
938955,291934,95,88,100,283,94.33333333333333,A+
939098,384550,100,86,92,278,92.66666666666667,A+
939229,203677,88,87,97,272,90.66666666666667,A+
939267,98814,77,99,97,273,91.0,A+
939530,564549,88,99,86,273,91.0,A+
939880,21910,95,89,92,276,92.0,A+
940060,1016479,81,97,95,273,91.0,A+
940066,764016,97,89,98,284,94.66666666666667,A+
940077,918385,100,86,99,285,95.0,A+
940152,909066,93,93,86,272,90.66666666666667,A+
940192,22656,98,99,85,282,94.0,A+
940512,534627,81,100,99,280,93.33333333333333,A+
940898,94485,100,83,94,277,92.33333333333333,A+
940939,172794,100,91,93,284,94.66666666666667,A+
941081,12587,87,91,99,277,92.33333333333333,A+
941152,111660,92,88,100,280,93.33333333333333,A+
941444,48929,94,88,100,282,94.0,A+
941761,983732,82,95,93,270,90.0,A+
941845,675368,96,76,99,271,90.33333333333333,A+
941880,975398,92,97,86,275,91.66666666666667,A+
941952,1015141,94,77,99,270,90.0,A+
942230,577457,94,87,100,281,93.66666666666667,A+
942279,1033977,98,94,78,270,90.0,A+
942467,24454,94,85,93,272,90.66666666666667,A+
942905,250492,87,89,97,273,91.0,A+
943001,482338,91,99,80,270,90.0,A+
943389,907936,90,82,99,271,90.33333333333333,A+
943745,702960,83,99,95,277,92.33333333333333,A+
943826,755071,95,82,97,274,91.33333333333333,A+
944249,675984,94,100,78,272,90.66666666666667,A+
944437,322058,78,97,99,274,91.33333333333333,A+
944443,993692,92,99,97,288,96.0,A+
944463,466302,89,88,99,276,92.0,A+
944605,265453,99,100,81,280,93.33333333333333,A+
945047,1037646,99,97,87,283,94.33333333333333,A+
945464,155271,93,97,92,282,94.0,A+
945852,21842,96,90,84,270,90.0,A+
945982,1017385,81,95,99,275,91.66666666666667,A+
946373,250883,97,90,88,275,91.66666666666667,A+
946533,120781,94,97,90,281,93.66666666666667,A+
946809,306992,97,99,89,285,95.0,A+
946873,573940,96,95,86,277,92.33333333333333,A+
946927,866024,94,92,96,282,94.0,A+
947091,557726,85,87,99,271,90.33333333333333,A+
947264,366177,91,82,97,270,90.0,A+
947367,397928,94,97,93,284,94.66666666666667,A+
947985,299754,79,99,99,277,92.33333333333333,A+
948353,1033488,98,94,82,274,91.33333333333333,A+
948384,8832,98,99,85,282,94.0,A+
948451,739339,91,97,90,278,92.66666666666667,A+
948628,682741,75,98,98,271,90.33333333333333,A+
949073,597358,94,90,94,278,92.66666666666667,A+
949277,760848,99,96,85,280,93.33333333333333,A+
949320,537500,98,98,81,277,92.33333333333333,A+
949361,56608,94,88,98,280,93.33333333333333,A+
949426,706629,99,91,99,289,96.33333333333333,A+
949503,31601,100,73,99,272,90.66666666666667,A+
949574,727055,100,95,83,278,92.66666666666667,A+
949623,496413,100,98,75,273,91.0,A+
949659,657331,84,95,91,270,90.0,A+
949873,110400,84,91,99,274,91.33333333333333,A+
950399,747881,96,82,96,274,91.33333333333333,A+
950503,779723,80,98,99,277,92.33333333333333,A+
950699,941771,83,94,97,274,91.33333333333333,A+
950824,829681,87,96,96,279,93.0,A+
950992,717934,82,97,97,276,92.0,A+
951293,935694,98,81,98,277,92.33333333333333,A+
951345,882011,94,92,84,270,90.0,A+
951471,313828,88,99,94,281,93.66666666666667,A+
951572,360718,96,99,99,294,98.0,A+
951585,495227,100,99,79,278,92.66666666666667,A+
951625,148845,93,95,98,286,95.33333333333333,A+
951683,600005,93,85,97,275,91.66666666666667,A+
951965,283833,87,91,97,275,91.66666666666667,A+
952204,990658,100,96,77,273,91.0,A+
952220,290552,98,100,100,298,99.33333333333333,A+
952770,996162,97,86,88,271,90.33333333333333,A+
953123,456079,90,92,100,282,94.0,A+
953147,455357,100,96,83,279,93.0,A+
953402,953931,93,99,82,274,91.33333333333333,A+
953428,32530,97,95,84,276,92.0,A+
953551,850806,95,94,97,286,95.33333333333333,A+
953584,904536,95,99,87,281,93.66666666666667,A+
953604,85625,87,99,85,271,90.33333333333333,A+
953723,896704,77,100,99,276,92.0,A+
953780,119840,94,98,93,285,95.0,A+
953789,58283,94,87,89,270,90.0,A+
953810,231728,99,97,87,283,94.33333333333333,A+
954067,836914,96,96,89,281,93.66666666666667,A+
954149,527657,99,99,96,294,98.0,A+
954156,54853,92,80,99,271,90.33333333333333,A+
954280,533802,99,100,98,297,99.0,A+
954362,1030615,96,85,96,277,92.33333333333333,A+
954498,394430,92,92,94,278,92.66666666666667,A+
954644,944333,94,100,95,289,96.33333333333333,A+
954699,594294,96,96,82,274,91.33333333333333,A+
954790,24190,98,98,81,277,92.33333333333333,A+
954861,123918,93,93,90,276,92.0,A+
954872,231171,100,99,83,282,94.0,A+
954925,855825,93,88,92,273,91.0,A+
954929,316476,87,94,98,279,93.0,A+
955201,436349,97,81,93,271,90.33333333333333,A+
955501,357942,92,85,95,272,90.66666666666667,A+
955698,503341,95,84,100,279,93.0,A+
955784,524160,98,94,97,289,96.33333333333333,A+
955926,1047208,98,94,80,272,90.66666666666667,A+
956134,169474,83,98,89,270,90.0,A+
956297,262225,88,92,97,277,92.33333333333333,A+
956299,936121,92,93,88,273,91.0,A+
956576,1043583,99,99,85,283,94.33333333333333,A+
956622,118782,77,100,99,276,92.0,A+
956730,755420,95,81,97,273,91.0,A+
956855,532608,97,95,82,274,91.33333333333333,A+
956886,968820,89,85,97,271,90.33333333333333,A+
957021,1023988,89,95,100,284,94.66666666666667,A+
957246,220649,89,92,96,277,92.33333333333333,A+
957259,199958,100,95,76,271,90.33333333333333,A+
957469,1023504,90,99,84,273,91.0,A+
957771,265270,89,98,94,281,93.66666666666667,A+
957888,750681,97,89,94,280,93.33333333333333,A+
957996,856565,87,99,88,274,91.33333333333333,A+
958105,985298,96,80,97,273,91.0,A+
958289,82862,93,90,98,281,93.66666666666667,A+
958316,281497,88,94,100,282,94.0,A+
958330,193392,99,92,87,278,92.66666666666667,A+
958409,108694,100,84,88,272,90.66666666666667,A+
958462,93445,94,95,97,286,95.33333333333333,A+
958497,87851,100,82,96,278,92.66666666666667,A+
958500,420819,99,85,88,272,90.66666666666667,A+
958584,693643,100,90,95,285,95.0,A+
958724,426169,93,97,90,280,93.33333333333333,A+
958817,192383,100,95,81,276,92.0,A+
958856,1024831,98,94,93,285,95.0,A+
958863,790050,94,82,95,271,90.33333333333333,A+
958997,296024,96,93,97,286,95.33333333333333,A+
959064,100385,100,84,98,282,94.0,A+
959307,330134,96,96,84,276,92.0,A+
959346,65730,96,96,89,281,93.66666666666667,A+
959741,958750,93,100,93,286,95.33333333333333,A+
959982,902024,95,100,99,294,98.0,A+
960095,425527,90,87,99,276,92.0,A+
960118,919894,94,98,82,274,91.33333333333333,A+
960550,993093,98,89,97,284,94.66666666666667,A+
961053,57073,96,97,99,292,97.33333333333333,A+
961202,165286,92,94,88,274,91.33333333333333,A+
961355,460310,92,98,92,282,94.0,A+
961481,97622,84,89,99,272,90.66666666666667,A+
961566,86591,92,85,95,272,90.66666666666667,A+
961781,738502,91,97,94,282,94.0,A+
962097,692731,91,93,94,278,92.66666666666667,A+
962113,256301,90,100,99,289,96.33333333333333,A+
962169,780016,99,98,85,282,94.0,A+
962191,176498,93,99,78,270,90.0,A+
962375,327714,93,87,100,280,93.33333333333333,A+
962455,578446,97,97,91,285,95.0,A+
963306,783355,88,93,91,272,90.66666666666667,A+
963403,590486,87,99,100,286,95.33333333333333,A+
963537,33142,93,82,97,272,90.66666666666667,A+
963690,653363,94,99,93,286,95.33333333333333,A+
963843,497661,98,92,99,289,96.33333333333333,A+
964263,1018759,99,96,78,273,91.0,A+
964453,432173,92,97,97,286,95.33333333333333,A+
964569,522790,80,98,97,275,91.66666666666667,A+
964690,129464,84,94,97,275,91.66666666666667,A+
964768,1029759,99,98,85,282,94.0,A+
964947,570266,94,88,98,280,93.33333333333333,A+
965069,44172,100,75,95,270,90.0,A+
965236,779355,99,100,79,278,92.66666666666667,A+
965248,715733,74,100,98,272,90.66666666666667,A+
965317,421027,83,94,97,274,91.33333333333333,A+
965925,752649,100,99,77,276,92.0,A+
966126,827144,97,99,91,287,95.66666666666667,A+
966497,567135,97,96,78,271,90.33333333333333,A+
966624,384067,94,96,99,289,96.33333333333333,A+
966759,259204,99,100,77,276,92.0,A+
967083,803531,87,93,97,277,92.33333333333333,A+
967153,43768,88,98,92,278,92.66666666666667,A+
967523,334451,93,87,100,280,93.33333333333333,A+
967556,465152,89,90,97,276,92.0,A+
967713,953706,89,86,99,274,91.33333333333333,A+
967749,231483,99,97,89,285,95.0,A+
967868,601650,86,94,97,277,92.33333333333333,A+
968539,204911,91,97,86,274,91.33333333333333,A+
968690,211050,97,87,86,270,90.0,A+
968769,965836,93,100,93,286,95.33333333333333,A+
968904,182148,99,90,82,271,90.33333333333333,A+
969232,832818,86,91,95,272,90.66666666666667,A+
969245,319729,88,99,98,285,95.0,A+
969504,122696,93,92,100,285,95.0,A+
969697,108199,76,95,100,271,90.33333333333333,A+
970142,254967,89,95,87,271,90.33333333333333,A+
971122,351777,95,97,78,270,90.0,A+
971189,81810,100,81,96,277,92.33333333333333,A+
971374,978224,99,90,97,286,95.33333333333333,A+
971475,184179,100,94,93,287,95.66666666666667,A+
971521,135993,99,85,88,272,90.66666666666667,A+
971642,38320,88,96,89,273,91.0,A+
971663,442946,97,81,98,276,92.0,A+
971701,121778,91,84,97,272,90.66666666666667,A+
972270,752264,100,98,83,281,93.66666666666667,A+
972291,315277,100,75,97,272,90.66666666666667,A+
972332,629621,94,96,80,270,90.0,A+
972336,871612,95,95,95,285,95.0,A+
972514,970092,100,92,97,289,96.33333333333333,A+
972692,180822,99,90,90,279,93.0,A+
972767,977423,99,92,95,286,95.33333333333333,A+
972786,886121,76,95,100,271,90.33333333333333,A+
972960,1015935,100,98,85,283,94.33333333333333,A+
972997,699011,82,94,95,271,90.33333333333333,A+
973005,193148,99,92,89,280,93.33333333333333,A+
973112,503879,98,95,89,282,94.0,A+
973180,970862,100,93,85,278,92.66666666666667,A+
973221,686801,100,91,93,284,94.66666666666667,A+
973310,741925,99,93,82,274,91.33333333333333,A+
973450,1025516,80,94,99,273,91.0,A+
973534,840571,94,89,98,281,93.66666666666667,A+
973645,565411,94,86,93,273,91.0,A+
973741,113066,94,96,99,289,96.33333333333333,A+
973759,877757,95,95,97,287,95.66666666666667,A+
974067,435908,100,92,91,283,94.33333333333333,A+
974137,780316,96,87,92,275,91.66666666666667,A+
974889,689595,93,97,94,284,94.66666666666667,A+
975195,236815,82,100,95,277,92.33333333333333,A+
975396,355955,92,87,98,277,92.33333333333333,A+
975564,621447,86,97,89,272,90.66666666666667,A+
975782,938781,94,99,91,284,94.66666666666667,A+
976071,547129,97,94,82,273,91.0,A+
976449,181421,93,100,91,284,94.66666666666667,A+
976503,511021,95,83,98,276,92.0,A+
976524,666227,98,80,93,271,90.33333333333333,A+
976865,980070,98,87,98,283,94.33333333333333,A+
976968,996699,100,98,77,275,91.66666666666667,A+
977084,806258,96,90,86,272,90.66666666666667,A+
977238,12941,96,91,96,283,94.33333333333333,A+
977339,888676,93,90,96,279,93.0,A+
977446,736997,98,89,90,277,92.33333333333333,A+
977639,468332,82,97,93,272,90.66666666666667,A+
977983,780805,96,87,88,271,90.33333333333333,A+
978048,100214,86,97,93,276,92.0,A+
978069,413696,99,84,94,277,92.33333333333333,A+
978763,911445,94,97,97,288,96.0,A+
979365,846929,95,92,84,271,90.33333333333333,A+
979908,312789,97,100,91,288,96.0,A+
980284,484314,96,82,95,273,91.0,A+
980433,886677,91,82,99,272,90.66666666666667,A+
980441,690182,83,97,95,275,91.66666666666667,A+
980508,846336,95,93,86,274,91.33333333333333,A+
980560,508806,100,99,81,280,93.33333333333333,A+
980591,354016,96,100,93,289,96.33333333333333,A+
981152,1002111,100,98,85,283,94.33333333333333,A+
981177,982100,91,96,92,279,93.0,A+
981241,172824,91,92,90,273,91.0,A+
981392,515850,90,98,90,278,92.66666666666667,A+
981634,420574,83,95,95,273,91.0,A+
981671,448968,100,95,83,278,92.66666666666667,A+
981882,140848,84,97,98,279,93.0,A+
981983,147023,76,100,96,272,90.66666666666667,A+
982196,666575,98,80,93,271,90.33333333333333,A+
982265,831320,87,94,93,274,91.33333333333333,A+
982343,813057,86,89,97,272,90.66666666666667,A+
982496,545699,97,95,89,281,93.66666666666667,A+
982762,166331,91,92,87,270,90.0,A+
982786,289415,94,83,93,270,90.0,A+
983233,526037,88,93,95,276,92.0,A+
983249,529222,90,100,88,278,92.66666666666667,A+
983283,73477,95,94,94,283,94.33333333333333,A+
983285,74246,95,95,82,272,90.66666666666667,A+
983375,267006,95,86,92,273,91.0,A+
983467,665292,92,91,98,281,93.66666666666667,A+
983499,583742,94,89,98,281,93.66666666666667,A+
983509,496340,99,96,87,282,94.0,A+
983729,532420,94,83,93,270,90.0,A+
983747,891513,95,97,88,280,93.33333333333333,A+
983963,501011,97,91,82,270,90.0,A+
984400,253494,95,84,98,277,92.33333333333333,A+
984488,772617,100,100,79,279,93.0,A+
984572,911574,91,88,93,272,90.66666666666667,A+
985048,655833,85,98,89,272,90.66666666666667,A+
985065,320119,97,100,89,286,95.33333333333333,A+
985244,871496,92,85,93,270,90.0,A+
985308,91036,87,100,94,281,93.66666666666667,A+
985333,397958,85,99,89,273,91.0,A+
985729,22577,88,97,100,285,95.0,A+
986387,171639,91,93,94,278,92.66666666666667,A+
986585,463238,91,95,88,274,91.33333333333333,A+
986660,815154,94,86,94,274,91.33333333333333,A+
986907,83467,96,99,95,290,96.66666666666667,A+
986950,676015,93,97,92,282,94.0,A+
986982,923753,82,90,99,271,90.33333333333333,A+
987315,64929,96,98,87,281,93.66666666666667,A+
987326,494561,99,97,93,289,96.33333333333333,A+
987354,798286,93,80,97,270,90.0,A+
987411,99511,77,98,96,271,90.33333333333333,A+
987854,241950,98,93,86,277,92.33333333333333,A+
987963,530237,98,97,91,286,95.33333333333333,A+
988516,498486,95,82,95,272,90.66666666666667,A+
988813,815447,97,97,85,279,93.0,A+
988828,947880,98,83,100,281,93.66666666666667,A+
989040,777632,97,90,94,281,93.66666666666667,A+
989109,890866,83,87,100,270,90.0,A+
989212,491168,98,92,97,287,95.66666666666667,A+
989302,827382,88,100,92,280,93.33333333333333,A+
989347,744615,92,100,82,274,91.33333333333333,A+
989423,158792,92,93,86,271,90.33333333333333,A+
989515,447990,100,95,91,286,95.33333333333333,A+
989523,805274,87,90,97,274,91.33333333333333,A+
989690,738808,97,85,98,280,93.33333333333333,A+
989962,139093,98,79,93,270,90.0,A+
990273,329229,96,98,80,274,91.33333333333333,A+
990277,474555,92,100,80,272,90.66666666666667,A+
990298,749734,88,90,99,277,92.33333333333333,A+
990446,801080,86,86,99,271,90.33333333333333,A+
990586,601552,95,94,92,281,93.66666666666667,A+
990785,106541,95,99,82,276,92.0,A+
990973,481470,100,97,87,284,94.66666666666667,A+
991140,192555,100,93,91,284,94.66666666666667,A+
991265,253739,95,84,96,275,91.66666666666667,A+
991290,425612,93,99,86,278,92.66666666666667,A+
991366,962547,91,93,98,282,94.0,A+
991516,884336,98,75,99,272,90.66666666666667,A+
991993,893880,93,92,100,285,95.0,A+
992376,167627,100,90,82,272,90.66666666666667,A+
992706,971266,81,92,99,272,90.66666666666667,A+
992729,236294,98,92,80,270,90.0,A+
992731,278807,95,87,100,282,94.0,A+
992901,914655,93,95,84,272,90.66666666666667,A+
993002,490043,81,96,95,272,90.66666666666667,A+
993149,572742,78,96,96,270,90.0,A+
993409,507921,81,99,97,277,92.33333333333333,A+
993526,223199,97,88,94,279,93.0,A+
993551,978010,90,92,96,278,92.66666666666667,A+
993918,481037,97,86,100,283,94.33333333333333,A+
994122,787721,89,95,100,284,94.66666666666667,A+
994454,1036656,96,87,96,279,93.0,A+
994912,1028555,88,90,93,271,90.33333333333333,A+
995047,504748,98,92,99,289,96.33333333333333,A+
995209,1028561,97,89,90,276,92.0,A+
995401,695581,96,77,99,272,90.66666666666667,A+
995466,944076,91,90,98,279,93.0,A+
995706,128528,93,95,96,284,94.66666666666667,A+
995816,915933,98,79,100,277,92.33333333333333,A+
996080,175417,93,100,84,277,92.33333333333333,A+
996582,439394,83,98,95,276,92.0,A+
996583,4876,88,95,87,270,90.0,A+
996895,826643,95,89,96,280,93.33333333333333,A+
997049,1038900,98,94,91,283,94.33333333333333,A+
997884,466198,89,88,97,274,91.33333333333333,A+
998006,419223,93,98,86,277,92.33333333333333,A+
998056,850585,93,85,93,271,90.33333333333333,A+
999040,519445,97,93,88,278,92.66666666666667,A+
999272,400918,83,93,99,275,91.66666666666667,A+
999366,375960,92,89,94,275,91.66666666666667,A+
999719,965231,90,90,95,275,91.66666666666667,A+
999851,527052,96,90,98,284,94.66666666666667,A+
1000374,36187,79,98,99,276,92.0,A+
1000481,71019,84,88,99,271,90.33333333333333,A+
1000662,758372,100,98,91,289,96.33333333333333,A+
1000719,347162,94,91,92,277,92.33333333333333,A+
1000989,682160,93,98,95,286,95.33333333333333,A+
1001191,471340,99,91,91,281,93.66666666666667,A+
1001225,530377,98,97,87,282,94.0,A+
1001471,783777,97,91,96,284,94.66666666666667,A+
1001494,1037640,90,97,90,277,92.33333333333333,A+
1002272,67400,94,92,100,286,95.33333333333333,A+
1002385,718001,97,84,100,281,93.66666666666667,A+
1002488,1001762,100,99,85,284,94.66666666666667,A+
1002536,305170,96,93,82,271,90.33333333333333,A+
1002578,926199,75,97,100,272,90.66666666666667,A+
1002710,819428,98,99,100,297,99.0,A+
1002851,133652,91,88,93,272,90.66666666666667,A+
1003375,564464,85,87,99,271,90.33333333333333,A+
1003605,306876,95,89,88,272,90.66666666666667,A+
1003880,820149,95,89,94,278,92.66666666666667,A+
1004011,875439,84,90,97,271,90.33333333333333,A+
1004411,933920,84,97,89,270,90.0,A+
1004427,374394,93,93,84,270,90.0,A+
1005161,551135,79,97,97,273,91.0,A+
1005628,522698,99,98,89,286,95.33333333333333,A+
1005661,543700,80,98,97,275,91.66666666666667,A+
1005665,327151,100,78,94,272,90.66666666666667,A+
1005915,51343,88,98,88,274,91.33333333333333,A+
1005988,260171,89,96,92,277,92.33333333333333,A+
1006048,424035,84,99,100,283,94.33333333333333,A+
1006079,782273,88,93,98,279,93.0,A+
1006111,602451,85,92,99,276,92.0,A+
1006209,879920,94,95,84,273,91.0,A+
1006688,1068,96,87,100,283,94.33333333333333,A+
1006721,436049,100,93,87,280,93.33333333333333,A+
1006901,250186,97,91,88,276,92.0,A+
1007242,981292,98,88,88,274,91.33333333333333,A+
1007335,437932,100,91,82,273,91.0,A+
1007446,733292,81,96,93,270,90.0,A+
1007459,7732,87,89,95,271,90.33333333333333,A+
1007475,246445,96,85,92,273,91.0,A+
1007626,162149,93,98,88,279,93.0,A+
1007945,939821,84,98,93,275,91.66666666666667,A+
1007986,529185,89,98,94,281,93.66666666666667,A+
1008262,817043,87,95,91,273,91.0,A+
1008450,417786,84,99,96,279,93.0,A+
1008492,748761,90,94,87,271,90.33333333333333,A+
1008637,1004814,96,82,98,276,92.0,A+
1009035,937625,100,91,87,278,92.66666666666667,A+
1009036,500003,91,99,99,289,96.33333333333333,A+
1009186,1008592,97,88,88,273,91.0,A+
1009770,111219,95,99,97,291,97.0,A+
1009794,291903,96,91,86,273,91.0,A+
1009870,616702,94,94,84,272,90.66666666666667,A+
1010356,895023,99,79,100,278,92.66666666666667,A+
1010540,505689,97,91,97,285,95.0,A+
1010647,918770,85,97,98,280,93.33333333333333,A+
1010842,792410,99,99,91,289,96.33333333333333,A+
1011252,237512,97,88,90,275,91.66666666666667,A+
1011282,144792,92,91,96,279,93.0,A+
1012134,259198,90,100,80,270,90.0,A+
1012314,944773,91,89,98,278,92.66666666666667,A+
1012541,120323,85,98,91,274,91.33333333333333,A+
1012732,450870,81,91,98,270,90.0,A+
1013111,568988,97,99,100,296,98.66666666666667,A+
1013284,256179,79,91,100,270,90.0,A+
1013590,326637,94,91,86,271,90.33333333333333,A+
1013650,760347,96,86,90,272,90.66666666666667,A+
1014337,676332,94,99,78,271,90.33333333333333,A+
1014354,659287,92,91,92,275,91.66666666666667,A+
1014531,894301,94,93,88,275,91.66666666666667,A+
1014581,472874,98,90,86,274,91.33333333333333,A+
1014585,961532,98,86,90,274,91.33333333333333,A+
1014594,177019,92,97,88,277,92.33333333333333,A+
1014878,70963,87,99,90,276,92.0,A+
1014895,543296,98,99,83,280,93.33333333333333,A+
1015099,205021,100,96,85,281,93.66666666666667,A+
1015123,525786,79,93,100,272,90.66666666666667,A+
1015819,905985,91,85,95,271,90.33333333333333,A+
1015877,953338,93,99,84,276,92.0,A+
1016013,613627,86,97,96,279,93.0,A+
1016019,724818,91,97,90,278,92.66666666666667,A+
1016121,597596,85,90,95,270,90.0,A+
1016262,9272,95,88,88,271,90.33333333333333,A+
1016272,891422,98,75,99,272,90.66666666666667,A+
1016532,812953,86,90,95,271,90.33333333333333,A+
1016600,635229,76,96,98,270,90.0,A+
1016626,706445,97,83,90,270,90.0,A+
1016734,311767,95,93,86,274,91.33333333333333,A+
1016789,591604,88,100,88,276,92.0,A+
1017058,318157,95,93,86,274,91.33333333333333,A+
1017158,898703,94,97,90,281,93.66666666666667,A+
1017364,623709,100,81,94,275,91.66666666666667,A+
1018060,595303,95,94,88,277,92.33333333333333,A+
1018178,200411,100,94,78,272,90.66666666666667,A+
1018792,29674,98,100,77,275,91.66666666666667,A+
1019000,380747,93,93,90,276,92.0,A+
1019029,399872,99,84,94,277,92.33333333333333,A+
1019289,376002,86,100,90,276,92.0,A+
1019351,173075,100,92,85,277,92.33333333333333,A+
1019429,836377,93,84,100,277,92.33333333333333,A+
1019560,529626,86,87,97,270,90.0,A+
1019608,876552,99,76,99,274,91.33333333333333,A+
1020082,14470,71,100,100,271,90.33333333333333,A+
1020738,984826,100,94,80,274,91.33333333333333,A+
1020758,769708,97,90,99,286,95.33333333333333,A+
1021106,1018821,89,94,90,273,91.0,A+
1021136,392718,84,96,91,271,90.33333333333333,A+
1021352,784137,99,100,96,295,98.33333333333333,A+
1021652,436698,82,91,99,272,90.66666666666667,A+
1021762,813626,88,98,100,286,95.33333333333333,A+
1021950,32390,96,94,88,278,92.66666666666667,A+
1022037,713532,82,94,95,271,90.33333333333333,A+
1022061,988789,88,86,99,273,91.0,A+
1022086,18804,88,95,89,272,90.66666666666667,A+
1022093,495991,99,97,87,283,94.33333333333333,A+
1022131,250401,90,100,94,284,94.66666666666667,A+
1022218,381365,98,79,100,277,92.33333333333333,A+
1022255,460652,98,87,90,275,91.66666666666667,A+
1022505,530267,89,98,88,275,91.66666666666667,A+
1022779,605117,96,97,99,292,97.33333333333333,A+
1022797,371876,100,84,94,278,92.66666666666667,A+
1022812,337380,77,95,100,272,90.66666666666667,A+
1023118,214602,96,81,93,270,90.0,A+
1023490,836534,97,99,74,270,90.0,A+
1023888,503530,99,95,89,283,94.33333333333333,A+
1024033,419627,90,86,95,271,90.33333333333333,A+
1024150,660400,91,88,100,279,93.0,A+
1024231,378828,93,93,100,286,95.33333333333333,A+
1024492,998112,96,83,91,270,90.0,A+
1024717,169756,92,95,98,285,95.0,A+
1025229,347964,78,100,99,277,92.33333333333333,A+
1025599,729765,89,89,97,275,91.66666666666667,A+
1025810,1024691,98,93,97,288,96.0,A+
1025851,18045,98,97,78,273,91.0,A+
1025889,572895,96,96,87,279,93.0,A+
1026034,224874,97,87,86,270,90.0,A+
1026142,543987,89,99,86,274,91.33333333333333,A+
1026457,586370,96,97,87,280,93.33333333333333,A+
1026520,314489,87,97,100,284,94.66666666666667,A+
1026549,924309,97,78,97,272,90.66666666666667,A+
1026614,495907,96,84,100,280,93.33333333333333,A+
1026748,492562,97,90,97,284,94.66666666666667,A+
1027402,213673,99,92,95,286,95.33333333333333,A+
1027747,986887,92,100,88,280,93.33333333333333,A+
1027946,879138,91,84,97,272,90.66666666666667,A+
1027976,591776,87,98,98,283,94.33333333333333,A+
1027993,111843,86,100,92,278,92.66666666666667,A+
1028496,510090,90,98,82,270,90.0,A+
1028534,748730,98,92,91,281,93.66666666666667,A+
1028663,701768,90,89,97,276,92.0,A+
1028717,442389,97,83,94,274,91.33333333333333,A+
1028789,146338,94,100,91,285,95.0,A+
1028794,896147,93,90,90,273,91.0,A+
1028866,629958,100,81,98,279,93.0,A+
1028915,689032,99,88,88,275,91.66666666666667,A+
1028955,993582,83,100,97,280,93.33333333333333,A+
1029055,761405,98,94,89,281,93.66666666666667,A+
1029101,949805,91,93,92,276,92.0,A+
1029393,328906,87,96,98,281,93.66666666666667,A+
1029477,889869,86,99,94,279,93.0,A+
1029822,761025,99,97,74,270,90.0,A+
1029871,1015080,73,100,98,271,90.33333333333333,A+
1030130,899945,75,95,100,270,90.0,A+
1030207,507077,88,89,99,276,92.0,A+
1030325,430082,93,100,97,290,96.66666666666667,A+
1030397,266847,98,98,81,277,92.33333333333333,A+
1030404,213049,99,95,83,277,92.33333333333333,A+
1030433,75195,97,100,100,297,99.0,A+
1030473,574637,96,94,86,276,92.0,A+
1031054,1147,90,100,90,280,93.33333333333333,A+
1031153,656535,93,96,86,275,91.66666666666667,A+
1031278,1018192,89,93,98,280,93.33333333333333,A+
1031291,314929,100,75,97,272,90.66666666666667,A+
1031343,1038692,98,95,87,280,93.33333333333333,A+
1031363,771353,90,99,98,287,95.66666666666667,A+
1031373,782523,97,93,93,283,94.33333333333333,A+
1031442,392339,93,95,94,282,94.0,A+
1031556,118049,92,89,100,281,93.66666666666667,A+
1031943,681597,100,89,88,277,92.33333333333333,A+
1032075,280378,79,98,95,272,90.66666666666667,A+
1032101,156977,92,93,98,283,94.33333333333333,A+
1032160,273475,97,95,99,291,97.0,A+
1032507,766749,99,96,89,284,94.66666666666667,A+
1032594,413243,99,85,92,276,92.0,A+
1032639,87581,95,95,86,276,92.0,A+
1032876,169437,99,86,90,275,91.66666666666667,A+
1032918,48837,97,99,97,293,97.66666666666667,A+
1033072,437088,91,92,89,272,90.66666666666667,A+
1033250,299057,95,89,94,278,92.66666666666667,A+
1033334,362423,87,100,88,275,91.66666666666667,A+
1033534,177673,82,95,97,274,91.33333333333333,A+
1033576,485366,89,91,97,277,92.33333333333333,A+
1034120,544544,89,97,90,276,92.0,A+
1034397,157913,82,93,99,274,91.33333333333333,A+
1034409,443331,82,92,97,271,90.33333333333333,A+
1034447,703798,83,98,91,272,90.66666666666667,A+
1034593,281087,97,96,89,282,94.0,A+
1035015,656701,84,94,99,277,92.33333333333333,A+
1035112,625110,93,90,96,279,93.0,A+
1035119,774832,95,84,96,275,91.66666666666667,A+
1035122,168258,93,97,97,287,95.66666666666667,A+
1035586,828954,96,95,99,290,96.66666666666667,A+
1035778,944822,94,100,91,285,95.0,A+
1036215,58081,87,98,88,273,91.0,A+
1036431,765074,99,97,98,294,98.0,A+
1036455,126504,86,100,87,273,91.0,A+
1036460,522301,96,87,96,279,93.0,A+
1036635,914446,94,96,80,270,90.0,A+
1036963,292679,98,98,93,289,96.33333333333333,A+
1037203,239775,95,83,100,278,92.66666666666667,A+
1037882,579180,97,98,85,280,93.33333333333333,A+
1038279,153578,97,77,99,273,91.0,A+
1038418,943031,91,91,98,280,93.33333333333333,A+
1038502,941869,89,84,97,270,90.0,A+
1038662,536272,89,98,94,281,93.66666666666667,A+
1038869,387032,93,94,88,275,91.66666666666667,A+
1038908,236650,99,98,100,297,99.0,A+
1039041,1042036,97,90,90,277,92.33333333333333,A+
1039108,51417,96,96,93,285,95.0,A+
1039286,622810,94,94,92,280,93.33333333333333,A+
1039320,996376,91,96,94,281,93.66666666666667,A+
1039355,682601,90,87,97,274,91.33333333333333,A+
1039393,726762,97,84,92,273,91.0,A+
1039408,322204,87,97,92,276,92.0,A+
1039557,115395,84,94,99,277,92.33333333333333,A+
1039638,778072,94,79,97,270,90.0,A+
1039834,854749,87,99,100,286,95.33333333333333,A+
1039863,989284,82,96,97,275,91.66666666666667,A+
1040050,561125,96,92,92,280,93.33333333333333,A+
1040244,677611,99,84,94,277,92.33333333333333,A+
1040424,1005137,90,95,85,270,90.0,A+
1040428,764053,82,100,97,279,93.0,A+
1040627,32005,96,94,95,285,95.0,A+
1041152,473981,88,87,97,272,90.66666666666667,A+
1042040,144235,92,93,92,277,92.33333333333333,A+
1042401,263271,87,91,97,275,91.66666666666667,A+
1042677,24710,97,95,91,283,94.33333333333333,A+
1043383,309921,96,95,84,275,91.66666666666667,A+
1043899,871844,77,95,98,270,90.0,A+
1043976,945959,90,88,93,271,90.33333333333333,A+
1044248,762652,89,92,95,276,92.0,A+
1044562,923447,92,91,90,273,91.0,A+
1044574,245619,99,96,95,290,96.66666666666667,A+
1044725,348422,86,98,98,282,94.0,A+
1044782,8301,89,98,98,285,95.0,A+
1045092,535366,90,100,90,280,93.33333333333333,A+
1045097,595615,95,92,94,281,93.66666666666667,A+
1045502,724293,91,96,100,287,95.66666666666667,A+
1045556,584615,94,89,88,271,90.33333333333333,A+
1045567,966277,90,89,95,274,91.33333333333333,A+
1045605,617981,99,78,100,277,92.33333333333333,A+
1045614,1040080,89,94,89,272,90.66666666666667,A+
1045624,593867,86,95,98,279,93.0,A+
1045640,202032,95,78,97,270,90.0,A+
1045778,248340,98,94,86,278,92.66666666666667,A+
1045918,633975,77,99,94,270,90.0,A+
1046084,752668,81,97,97,275,91.66666666666667,A+
1046471,305642,92,79,99,270,90.0,A+
1046728,566916,87,94,97,278,92.66666666666667,A+
1046758,726945,91,96,84,271,90.33333333333333,A+
1047708,564360,85,88,97,270,90.0,A+
1047821,562623,95,90,94,279,93.0,A+
1048302,227032,96,83,93,272,90.66666666666667,A+
1048339,886934,94,92,96,282,94.0,A+
1048511,764157,82,100,99,281,93.66666666666667,A+
1048573,360143,100,81,94,275,91.66666666666667,A+
